Num_children,Income,Wines,Fruits,Meat,Fish,Sweets,Gold,Total,labels
0,58138,635,88,546,172,88,88,1617,2
2,46344,11,1,6,2,1,6,27,0
0,71613,426,49,127,111,21,42,776,1
1,26646,11,4,20,10,3,5,53,0
1,58293,173,43,118,46,27,15,422,1
1,62513,520,42,98,0,42,14,716,1
1,55635,235,65,164,50,49,27,590,1
1,33454,76,10,56,3,1,23,169,0
1,30351,14,0,24,3,3,2,46,0
2,5648,28,0,6,1,1,13,49,0
0,7500,6,16,11,11,1,16,61,0
0,63033,194,61,480,225,112,30,1102,2
2,59354,233,2,53,3,5,14,310,0
0,17323,3,14,17,6,1,5,46,0
0,82800,1006,22,115,59,68,45,1315,2
2,41850,53,5,19,2,13,4,96,0
0,37760,84,5,38,150,12,28,317,0
1,76995,1012,80,498,0,16,176,1782,2
1,33812,4,17,19,30,24,39,133,0
0,37040,86,2,73,69,38,48,316,0
1,2447,1,1,1725,1,1,1,1730,1
1,58607,867,0,86,0,0,19,972,1
1,65324,384,0,102,21,32,5,544,1
1,40689,270,3,27,39,6,99,444,0
0,18589,6,4,25,15,12,13,75,0
2,53359,173,4,30,3,6,41,257,0
1,38360,36,2,42,20,21,10,131,0
0,84618,684,100,801,21,66,0,1672,2
0,10979,8,4,10,2,2,4,30,0
0,38620,112,17,44,34,22,89,318,0
1,40548,110,0,5,2,0,3,120,0
2,46610,96,12,96,33,22,43,302,0
0,68657,482,34,471,119,68,22,1196,2
2,49389,40,0,19,2,1,3,65,0
1,67353,702,17,151,0,8,35,913,1
1,23718,6,3,14,15,7,36,81,0
1,42429,55,0,6,2,0,4,67,0
0,48948,437,8,206,160,49,42,902,2
1,80011,421,76,536,82,178,102,1395,2
1,20559,13,1,29,3,0,7,53,0
1,21994,9,0,6,3,1,3,22,0
1,7500,3,1,10,3,2,12,31,0
0,79941,123,164,266,227,30,174,984,2
0,7500,3,18,14,15,22,50,122,0
1,41728,13,6,15,3,5,13,55,0
2,72550,826,50,317,50,38,38,1319,1
1,65486,245,19,125,37,67,14,507,1
0,79143,650,37,780,27,167,32,1693,2
1,35790,12,6,20,30,1,3,72,0
0,82582,510,120,550,156,40,241,1617,2
2,66373,328,9,124,12,24,109,606,1
0,82384,984,51,432,180,120,190,1957,2
0,70287,295,35,482,121,120,40,1093,2
1,27938,13,0,8,2,1,5,29,0
1,55954,447,0,28,0,0,43,518,1
0,75777,712,26,538,69,13,80,1438,2
2,66653,452,18,102,16,18,6,612,1
1,61823,523,7,134,37,14,169,884,1
1,67680,546,0,48,0,6,6,606,1
0,70666,398,40,367,119,122,30,1076,2
1,25721,1,3,6,3,6,15,34,0
2,32474,10,0,1,0,0,0,11,0
1,88194,688,14,309,201,24,38,1274,2
1,69096,247,49,159,7,82,109,653,1
3,74854,856,59,487,58,29,73,1562,1
0,66991,496,36,460,189,60,12,1253,2
1,65031,258,107,291,84,37,86,863,1
2,60631,565,6,65,0,6,19,661,1
0,28332,14,10,13,4,15,9,65,0
1,40246,2,1,6,2,1,1,13,0
0,75251,721,111,925,97,18,18,1890,2
0,75825,1032,105,779,137,105,51,2209,2
0,26326,1,0,5,0,3,9,18,0
0,56046,577,0,64,0,0,51,692,1
1,29760,64,4,68,7,5,17,165,0
1,26304,4,1,5,2,0,4,16,0
1,23559,25,5,19,7,0,23,79,0
0,38620,112,17,44,34,22,89,318,0
0,81361,163,23,424,27,65,76,778,1
2,29440,17,8,14,10,4,3,56,0
2,36138,130,0,16,0,0,5,151,0
1,50388,292,6,37,0,3,34,372,0
0,79593,350,60,568,110,133,145,1366,2
1,54178,135,9,39,4,0,7,194,0
1,42394,15,2,10,0,1,4,32,0
1,23626,27,2,14,0,0,0,43,0
1,30096,5,3,11,12,5,9,45,0
1,47916,505,0,26,0,0,75,606,1
2,51813,51,2,7,0,1,2,63,0
0,78497,207,26,447,75,0,223,978,1
0,50150,135,46,92,65,61,11,410,1
1,47823,53,1,5,2,1,10,72,0
1,34554,41,1,6,2,0,5,55,0
1,85693,386,172,183,185,132,111,1169,2
0,65846,562,81,276,80,40,81,1120,2
0,87195,217,76,690,50,26,38,1097,2
1,24594,1,3,6,10,0,9,29,0
2,49096,144,1,32,2,1,7,187,0
2,52413,295,106,271,75,98,65,910,1
1,38557,76,3,31,4,4,27,145,0
0,89058,454,194,106,31,22,43,850,2
1,77298,425,115,292,23,35,79,969,1
0,68126,1332,17,311,23,51,86,1820,2
1,57288,527,0,21,0,0,60,608,1
0,86037,490,44,125,29,20,22,730,1
1,43974,378,0,101,0,0,72,551,1
2,50785,64,1,21,0,1,27,114,0
0,90765,547,99,812,151,82,33,1724,2
1,36550,47,90,94,123,103,120,577,1
2,30753,12,5,25,0,9,30,81,0
1,21918,1,6,7,11,5,3,33,0
1,56129,320,48,133,39,72,48,660,1
1,32557,34,3,29,0,4,10,80,0
2,19510,9,0,7,3,4,7,30,0
1,30992,17,0,14,7,3,2,43,0
0,101970,722,27,102,44,72,168,1135,2
0,71488,162,33,124,40,28,172,559,1
0,79607,450,133,951,173,0,216,1923,2
2,54348,70,0,16,0,0,4,90,0
2,77376,492,19,110,16,12,12,661,1
1,62998,120,58,73,65,89,58,463,1
2,61331,534,5,47,0,5,41,632,1
0,73448,236,106,189,23,41,130,725,1
2,41551,220,0,33,3,0,23,279,0
0,62981,796,14,590,38,44,0,1482,2
1,9548,0,1,3,10,6,9,29,0
3,33762,53,1,34,2,0,16,106,0
2,35860,15,0,8,4,2,20,49,0
2,36921,17,1,12,3,1,4,38,0
0,92859,962,61,921,52,61,20,2077,2
1,65104,738,0,232,13,20,50,1053,1
0,86111,399,28,756,36,40,126,1385,2
1,68352,614,16,132,43,33,33,871,1
1,41883,32,34,41,73,16,116,312,0
2,59809,598,16,141,32,41,49,877,1
1,23957,2,1,18,20,11,16,68,0
1,38547,6,1,10,0,1,4,22,0
3,35688,73,3,90,12,1,32,211,0
0,49605,42,16,29,12,20,8,127,0
2,59354,295,21,78,39,13,13,459,0
1,65747,346,17,48,23,13,13,460,1
1,46344,233,20,57,8,20,91,429,0
1,34176,5,7,24,19,14,20,89,0
1,61010,888,0,57,0,0,76,1021,1
0,69372,997,26,269,34,13,42,1381,1
1,49967,212,6,69,4,12,3,306,0
3,60199,8,1,7,2,0,0,18,0
1,55375,42,11,57,10,28,14,162,0
0,80317,536,11,387,149,91,57,1231,2
3,30523,5,0,3,0,0,5,13,0
0,70356,1349,16,249,43,16,33,1706,2
1,23228,53,3,49,7,4,5,121,0
0,74165,1001,12,240,16,12,12,1293,1
3,43482,18,1,32,6,3,28,88,0
0,62551,125,16,98,134,21,27,421,1
0,52332,212,5,33,7,0,2,259,0
0,66951,277,162,305,173,76,124,1117,2
2,26091,15,10,19,8,17,20,89,0
2,33456,7,3,10,8,1,7,36,0
1,28718,12,4,6,11,8,16,57,0
2,50447,85,7,24,2,3,27,148,0
2,53537,81,0,6,0,0,6,93,0
1,52074,59,0,12,0,0,48,119,0
1,80427,1149,71,449,69,71,26,1835,2
0,83837,847,66,119,86,89,111,1318,2
2,38853,29,0,14,0,0,2,45,0
3,38285,2,0,5,2,0,1,10,0
0,78497,207,26,447,75,0,223,978,1
1,51650,152,3,22,2,5,7,191,0
1,16248,12,11,10,3,12,9,57,0
0,66835,620,26,195,34,17,141,1033,1
1,30477,47,1,6,0,0,12,66,0
0,28249,1,9,7,2,14,10,43,0
1,25271,10,1,18,10,4,7,50,0
1,32303,35,0,2,0,0,2,39,0
1,61286,356,0,107,19,9,117,608,1
0,74068,783,30,537,140,76,15,1581,2
2,45759,42,1,18,3,0,4,68,0
1,24882,1,4,10,29,0,36,80,0
0,66973,466,22,432,147,113,102,1282,2
1,38872,23,3,21,3,19,22,91,0
2,51148,235,6,45,8,9,12,315,0
2,31353,10,0,10,3,1,7,31,0
0,69661,656,16,106,32,16,8,834,1
0,80067,519,17,813,27,173,51,1600,2
0,86718,344,189,482,50,33,172,1270,2
2,46854,96,1,79,7,1,79,263,0
1,69142,448,4,34,6,4,39,535,1
0,75922,265,138,553,224,23,92,1295,2
1,63693,587,43,337,42,87,54,1150,1
0,102160,763,29,138,76,176,58,1240,2
2,40637,22,0,13,0,0,3,38,0
0,18890,6,4,1,7,2,15,35,0
1,29604,7,6,13,7,6,14,53,0
2,48721,81,18,113,47,13,21,293,0
1,44794,54,0,7,0,0,4,65,0
1,64497,1170,48,320,42,32,192,1804,2
1,46097,72,24,68,65,4,8,241,0
0,77972,613,22,319,33,102,12,1101,1
2,44377,224,0,30,0,0,10,264,0
2,46014,410,0,59,19,9,44,541,0
0,70951,239,10,554,254,87,54,1198,2
1,41443,171,7,171,25,19,89,482,0
3,52195,12,0,4,0,0,1,17,0
0,83790,1076,16,417,42,48,16,1615,2
1,44551,182,4,33,0,0,66,285,0
1,69508,824,32,162,42,32,43,1135,1
1,45204,30,11,25,29,1,18,114,0
0,72460,377,10,540,80,30,10,1047,1
2,77622,520,7,154,19,0,14,714,1
1,30732,155,1,25,0,1,3,185,0
1,63887,897,23,207,15,11,92,1245,1
1,42011,131,0,16,2,1,39,189,0
1,51369,297,7,79,0,11,182,576,1
1,51537,787,20,204,0,0,92,1103,1
0,79930,792,86,740,67,51,17,1753,2
1,34320,4,1,9,3,0,0,17,0
2,37070,231,7,137,4,15,39,433,0
1,81975,983,76,184,180,138,27,1588,2
1,38590,3,1,8,4,3,3,22,0
0,15033,0,4,5,6,0,4,19,0
1,62745,562,21,464,28,10,32,1117,1
1,22212,5,9,20,6,8,21,69,0
1,23661,18,0,4,0,0,1,23,0
1,79761,415,5,124,15,35,11,605,1
1,7500,5,3,10,12,7,20,57,0
0,73455,901,61,757,186,163,20,2088,2
1,64961,382,114,276,75,124,38,1009,2
1,22804,14,1,7,2,1,1,26,0
0,73687,559,153,503,218,13,181,1627,2
1,61074,789,0,133,0,28,152,1102,1
2,31686,11,0,5,0,0,1,17,0
1,80134,1218,16,272,104,0,80,1690,2
1,75027,925,64,179,133,12,77,1390,2
0,67546,864,134,768,150,38,172,2126,2
1,65176,960,28,183,220,70,70,1531,2
1,31160,16,3,25,6,1,13,64,0
1,29938,3,3,7,0,2,11,26,0
0,102692,168,148,444,32,172,148,1112,2
0,26490,45,47,52,21,20,25,210,0
2,75702,650,28,353,45,42,30,1148,1
1,30899,24,0,8,0,0,1,33,0
1,63342,918,21,118,13,10,21,1101,1
1,45989,138,33,87,28,24,12,322,0
2,18701,12,4,2,10,6,10,44,0
3,40737,11,0,4,0,0,2,17,0
1,15287,1,2,8,4,3,13,31,0
2,69674,554,41,215,11,0,24,845,1
1,44159,167,2,62,24,13,7,275,0
1,37717,9,0,6,4,1,5,25,0
2,43776,177,2,71,3,2,20,275,0
2,38179,38,4,22,4,2,20,90,0
0,80124,483,84,398,205,84,241,1495,2
2,38097,77,2,35,0,1,69,184,0
0,72940,182,74,298,162,149,116,981,2
1,22070,10,7,19,8,2,21,67,0
0,69267,778,44,499,95,73,146,1635,2
1,31788,16,7,23,0,8,6,60,0
1,61905,167,0,43,6,2,13,231,0
2,29315,13,2,14,8,7,4,48,0
2,33378,33,6,40,3,7,10,99,0
1,66313,625,7,99,10,22,7,770,1
0,60714,216,162,224,101,92,162,957,2
0,77882,68,129,396,188,22,15,818,2
0,69867,196,0,512,33,130,54,925,1
1,63841,635,15,100,20,7,131,908,1
1,24480,4,19,9,28,25,17,102,0
1,51369,297,7,79,0,11,182,576,1
0,37760,84,5,38,150,12,28,317,0
1,65640,204,7,149,20,15,66,461,1
2,44319,26,0,8,0,0,3,37,0
1,30631,15,6,20,4,5,20,70,0
0,75278,304,98,230,150,74,74,930,2
2,50898,285,28,242,55,114,135,859,1
0,79946,395,183,565,166,141,28,1478,2
0,35416,248,3,81,4,3,51,390,0
0,32414,20,6,5,0,9,12,52,0
1,38361,39,0,56,20,8,14,137,0
0,82497,777,129,573,216,21,203,1919,2
2,16626,8,3,22,21,1,13,68,0
2,29672,9,1,3,0,4,8,25,0
1,55951,1241,0,80,0,13,40,1374,1
1,35388,6,4,7,4,3,8,32,0
1,42386,65,4,16,0,4,11,100,0
0,68627,395,15,263,60,54,38,825,1
1,57912,801,0,80,0,0,35,916,1
2,35246,36,0,12,2,2,10,62,0
1,58821,513,14,154,19,0,28,728,1
1,46377,37,0,46,4,3,0,90,0
1,39747,80,15,93,20,13,52,273,0
1,23976,14,1,21,2,3,25,66,0
0,80950,525,147,112,219,147,63,1213,2
0,27038,1,26,25,17,23,15,107,0
0,77457,675,11,400,15,45,11,1157,1
1,64100,509,0,27,0,0,10,546,1
0,42670,154,2,46,20,4,15,241,0
1,12571,3,5,14,2,12,17,53,0
3,22574,25,0,8,2,0,2,37,0
0,70893,768,44,561,77,44,14,1508,2
2,54198,185,0,28,3,2,17,235,0
2,28839,24,0,7,0,0,1,32,0
2,40321,44,4,21,6,0,27,102,0
1,66503,91,64,128,65,3,50,401,1
2,30833,11,0,7,3,1,6,28,0
1,64795,412,5,119,38,29,77,680,1
1,34421,3,3,7,6,2,9,30,0
2,47025,16,0,3,0,0,1,20,0
1,64325,731,60,353,78,12,73,1307,1
1,40464,424,17,118,7,23,41,630,1
0,62187,792,0,275,45,45,126,1283,1
1,14849,21,2,28,3,2,9,65,0
1,27255,22,1,11,0,1,2,37,0
3,54432,33,0,5,0,0,0,38,0
1,29999,68,7,59,10,5,11,160,0
1,24072,9,1,6,3,0,4,23,0
0,33996,40,2,15,8,0,6,71,0
1,66334,909,11,218,0,0,23,1161,1
1,35178,23,1,13,2,2,18,59,0
1,22010,11,2,9,3,0,8,33,0
2,62204,317,46,247,151,46,139,946,1
0,75693,797,153,293,72,97,30,1442,2
1,30675,10,2,16,11,2,21,62,0
0,83003,856,61,570,40,25,122,1674,2
0,68655,456,19,832,75,118,38,1538,2
0,41411,37,32,38,11,3,18,139,0
1,55212,1103,0,45,0,0,34,1182,1
1,59292,378,14,68,19,14,14,507,1
1,27190,1,6,7,0,1,3,18,0
0,82623,204,34,204,172,153,173,940,2
2,44300,30,0,9,0,0,3,42,0
0,84835,189,104,379,111,189,218,1190,2
2,30372,15,0,12,7,3,7,44,0
1,33181,9,0,3,0,0,4,16,0
1,71113,495,33,255,11,33,8,835,1
1,71952,656,80,455,52,107,93,1443,2
0,69759,452,20,514,13,30,0,1029,1
0,72099,546,91,410,119,0,22,1188,2
1,60000,1048,0,217,0,0,12,1277,1
2,38643,22,2,14,0,1,10,49,0
1,50737,78,0,11,0,0,10,99,0
0,68462,561,64,785,84,128,48,1670,2
0,65073,629,17,177,69,0,8,900,1
2,46681,269,15,69,15,19,38,425,0
0,78618,736,163,818,212,163,61,2153,2
1,62187,512,0,83,0,0,41,636,1
2,28442,19,3,10,11,8,6,57,0
1,37717,9,0,6,4,1,5,25,0
2,51479,247,8,160,6,8,65,494,0
1,54803,404,0,92,28,27,142,693,1
0,79530,333,0,815,129,42,29,1348,2
1,31615,2,3,20,6,11,9,51,0
0,72025,833,33,549,151,133,233,1932,2
1,52614,789,0,142,12,9,38,990,1
1,35684,10,4,7,0,6,3,30,0
2,48178,159,4,45,6,2,38,254,0
1,29548,7,1,6,3,1,11,29,0
1,63810,977,12,253,16,12,101,1371,1
2,38578,38,4,22,3,3,3,73,0
2,46098,57,0,27,0,0,36,120,0
0,22585,3,9,15,13,2,39,81,0
1,30279,10,4,14,4,4,1,37,0
1,66426,1043,24,97,32,24,157,1377,1
1,30822,3,9,13,2,12,12,51,0
2,33581,11,0,5,0,0,1,17,0
1,19986,3,6,5,0,2,6,22,0
0,27421,43,12,96,78,40,55,324,0
3,35688,73,3,90,12,1,32,211,0
1,36143,12,0,1,0,0,6,19,0
1,10245,4,7,7,6,4,13,41,0
1,43795,314,11,53,4,3,107,492,1
1,63381,571,50,142,33,50,159,1005,1
1,38823,70,0,11,2,8,23,114,0
2,83664,866,21,151,28,21,86,1173,1
0,90300,594,134,786,33,134,57,1738,2
1,62499,140,4,61,0,13,4,222,0
0,74293,375,152,335,93,91,81,1127,2
0,51012,102,9,63,2,9,24,209,0
1,70777,554,35,113,0,7,78,787,1
0,68682,919,0,505,99,30,45,1598,2
2,43824,96,1,42,12,3,32,186,0
1,15345,5,2,16,3,2,19,47,0
1,23442,2,0,6,8,6,5,27,0
1,14515,6,4,9,6,36,35,96,0
2,31395,23,1,25,0,8,7,64,0
0,75276,610,105,125,137,42,21,1040,2
2,42373,67,5,61,3,8,19,163,0
0,30507,65,36,74,38,20,110,343,0
3,55521,416,0,26,0,0,4,446,0
2,48006,23,0,11,3,2,2,41,0
1,27213,19,3,26,10,9,3,70,0
2,65808,155,7,80,13,7,10,272,0
1,30351,14,0,24,3,3,2,46,0
2,50437,370,9,92,6,9,4,490,0
1,23616,4,22,11,3,7,32,79,0
1,53858,407,53,221,58,150,26,915,1
1,66465,1200,0,204,38,29,14,1485,1
1,46923,85,44,54,102,78,6,369,0
1,75072,583,34,309,0,22,125,1073,1
0,75865,483,0,591,156,0,12,1242,2
1,19789,2,5,9,28,6,28,78,0
0,80134,966,26,282,52,26,26,1378,2
0,91065,822,114,108,179,137,114,1474,2
2,49505,604,0,100,19,0,28,751,1
1,37401,19,3,19,3,1,3,48,0
1,30096,5,3,11,12,5,9,45,0
1,18492,2,2,2,2,1,1,10,0
0,82584,1076,68,103,29,91,68,1435,2
0,93027,1285,42,716,55,0,21,2119,2
3,48686,10,0,7,2,0,1,20,0
0,92910,551,137,792,179,103,33,1795,2
1,75433,800,0,297,0,34,57,1188,1
1,10404,2,2,11,10,6,12,43,0
1,61314,378,0,189,97,172,172,1008,1
0,84865,1248,16,349,43,16,16,1688,2
1,42387,235,0,235,19,4,191,684,1
2,67309,515,47,181,149,95,95,1082,1
1,75236,438,66,400,12,38,114,1068,1
1,30015,25,0,22,2,3,5,57,0
1,50943,31,0,7,2,0,6,46,0
1,67272,357,35,271,28,28,14,733,1
1,51529,400,4,35,6,0,22,467,0
1,32011,99,0,15,2,1,5,122,0
1,7500,1,11,5,4,6,9,36,0
1,28691,5,4,13,8,0,4,34,0
1,56223,77,28,31,16,0,4,156,0
0,18100,3,1,2,4,3,1,14,0
1,30279,10,4,14,4,4,1,37,0
0,20130,0,6,3,7,6,12,34,0
0,23295,0,0,1,2,12,5,20,0
1,42618,76,14,74,13,5,10,192,0
0,81246,398,190,537,61,156,37,1379,2
1,24027,14,7,11,11,0,5,48,0
1,55707,208,7,82,30,66,35,428,1
1,57959,430,16,322,43,24,33,868,1
1,56796,656,38,161,62,47,37,1001,1
1,36230,14,2,30,8,2,3,59,0
2,70829,141,70,106,72,19,23,431,1
1,65991,507,19,364,25,47,9,971,1
3,38988,164,24,103,12,3,42,348,0
0,89572,606,24,974,197,194,64,2059,2
1,42207,116,11,72,3,17,46,265,0
1,50300,143,15,60,24,23,5,270,0
0,66664,398,96,447,220,96,32,1289,2
1,60597,522,0,257,32,16,66,893,1
0,70165,161,0,253,199,191,122,926,2
1,50520,112,0,6,2,1,14,135,0
0,80124,483,84,398,205,84,241,1495,2
1,33183,7,5,39,17,15,37,120,0
0,66582,789,25,420,16,38,0,1288,1
0,75261,1239,17,413,23,34,17,1743,2
1,31880,4,1,5,2,0,3,15,0
2,53790,335,42,127,28,5,5,542,0
1,49269,639,8,166,11,8,58,890,1
1,61456,563,76,384,84,192,89,1388,2
1,37406,2,0,8,2,2,3,17,0
1,56937,746,8,125,11,8,8,906,1
2,38415,22,1,13,4,0,4,44,0
1,20518,4,1,6,4,1,9,25,0
1,62503,478,0,193,110,75,117,973,1
2,41644,20,3,4,2,0,2,31,0
1,55842,451,0,39,0,4,24,518,1
1,62010,371,22,39,6,0,92,530,1
1,41124,281,7,84,15,0,119,506,1
1,38961,19,7,19,0,1,24,70,0
1,37760,26,3,13,2,10,0,54,0
1,32233,138,15,35,25,11,72,296,0
1,43057,213,2,44,0,2,5,266,0
0,83151,407,28,100,120,74,18,747,2
0,78825,483,74,114,169,37,18,895,2
1,65104,738,0,232,13,20,50,1053,1
1,60093,502,12,109,16,6,90,735,1
1,14045,11,0,5,2,1,1,20,0
0,28457,24,1,108,29,29,14,205,0
1,78952,1170,19,594,99,76,134,2092,2
1,46310,185,2,88,15,5,14,309,0
0,76005,983,20,389,240,50,40,1722,2
1,58308,691,0,69,10,0,130,900,1
0,55614,504,13,131,8,0,26,682,1
1,59432,317,25,265,25,19,12,663,1
1,55563,29,1,9,2,0,2,43,0
1,78642,1396,0,322,46,35,17,1816,1
1,67911,529,0,356,63,28,0,976,1
0,65275,388,14,218,91,14,21,746,1
2,27203,13,2,21,4,0,24,64,0
1,48330,28,0,4,0,0,0,32,0
0,24279,16,36,21,20,62,108,263,0
1,64355,1047,0,140,67,38,153,1445,1
1,50943,31,0,7,2,0,6,46,0
0,53653,815,10,239,28,10,108,1210,1
1,65665,225,162,387,106,36,29,945,2
0,81217,493,70,324,146,40,84,1157,2
0,34935,34,4,66,3,10,20,137,0
1,61250,382,138,65,60,26,59,730,1
1,39665,127,1,56,0,1,31,216,0
1,60152,325,83,300,86,58,91,943,1
2,48920,238,17,68,8,10,6,347,0
0,89120,1168,92,408,72,129,55,1924,2
1,44124,284,0,55,0,6,52,397,0
0,81169,1288,20,613,80,61,27,2089,2
2,36443,65,0,46,4,3,20,138,0
1,26095,11,7,9,3,1,11,42,0
0,71367,227,23,389,42,21,75,777,1
0,80184,1035,134,670,25,38,0,1902,2
2,30630,27,1,12,2,0,10,52,0
0,73454,982,73,351,56,14,175,1651,2
0,42691,179,2,64,38,17,58,358,0
0,70503,1379,33,216,0,33,66,1727,2
1,25545,32,1,64,16,12,85,210,0
1,32880,8,4,15,7,6,2,42,0
0,77863,881,38,319,16,25,12,1291,1
0,50353,141,15,153,67,31,35,442,1
0,61839,1000,155,379,224,17,120,1895,2
2,49154,206,10,67,30,27,71,411,0
1,47682,162,61,83,97,57,61,521,1
1,72679,619,54,260,127,54,54,1168,2
2,57954,456,4,24,0,0,9,493,0
2,65316,112,6,92,3,9,38,260,0
1,28567,11,3,22,2,2,6,46,0
1,47352,172,12,112,8,0,15,319,0
1,44931,78,0,11,0,0,7,96,0
0,76982,464,151,292,65,60,30,1062,2
1,57247,99,4,32,37,54,6,232,0
1,22944,19,3,19,4,5,26,76,0
1,25315,1,9,8,11,3,22,54,0
1,43638,63,10,83,7,19,19,201,0
1,42710,252,3,42,4,3,102,406,0
0,84169,1478,19,403,0,19,0,1919,2
1,54058,198,18,252,32,108,54,662,1
1,24683,8,4,10,6,7,6,41,0
0,85620,416,46,925,60,107,46,1600,2
1,47850,42,7,43,20,12,10,134,0
2,19514,14,3,21,2,1,28,69,0
2,27159,17,0,3,0,0,1,21,0
2,39548,15,4,10,3,4,18,54,0
1,21474,6,16,24,11,0,34,91,0
1,60504,458,0,24,6,4,34,526,1
0,22419,30,3,47,19,21,42,162,0
0,81698,179,28,520,111,123,47,1008,2
2,43462,90,17,97,15,6,15,240,0
1,54880,308,85,137,102,45,118,795,1
0,79908,557,129,761,29,185,111,1772,2
0,15315,7,4,13,15,8,17,64,0
1,87771,1492,38,287,50,57,33,1957,2
1,33039,30,8,12,8,8,12,78,0
0,81741,249,153,940,58,134,38,1572,2
1,71499,465,25,132,136,0,37,795,1
1,62466,129,129,259,168,121,83,889,2
1,48799,174,18,81,28,6,24,331,0
1,52157,189,2,29,3,2,40,265,0
1,66565,747,10,161,65,40,42,1065,1
2,29298,6,0,2,2,0,1,11,0
1,47691,14,0,3,0,0,4,21,0
2,38200,12,0,4,0,0,1,17,0
1,44989,98,0,106,49,10,106,369,0
2,38443,32,0,5,0,0,1,38,0
1,38593,51,12,49,17,24,24,177,0
1,64413,200,5,44,0,10,20,279,0
1,36959,25,6,25,6,0,0,62,0
1,61996,1050,12,144,0,0,24,1230,1
2,51287,117,0,22,13,0,30,182,0
2,13260,9,4,17,10,2,7,49,0
2,47472,56,0,11,0,0,8,75,0
2,54603,145,13,46,17,2,4,227,0
2,45207,203,0,10,0,0,2,215,0
1,40689,270,3,27,39,6,99,444,0
2,47821,9,0,16,6,6,10,47,0
0,27450,37,12,23,8,11,52,143,0
1,39453,46,0,7,0,0,2,55,0
2,26850,31,1,13,7,2,9,63,0
0,79800,1060,21,530,32,0,224,1867,2
1,61794,264,47,188,54,47,11,611,1
1,53863,399,4,30,6,4,30,473,1
0,24221,8,9,9,2,5,22,55,0
1,39684,19,0,35,6,4,17,81,0
0,92163,817,183,797,106,163,20,2086,2
0,69882,292,127,635,132,127,165,1478,2
1,33178,12,6,2,11,2,16,49,0
0,59973,130,30,168,20,34,0,382,1
1,17459,6,4,16,3,10,30,69,0
1,23910,16,12,18,7,1,13,67,0
2,42169,19,0,9,0,0,2,30,0
1,26224,4,7,15,13,9,15,63,0
1,31089,31,3,31,2,8,4,79,0
1,30081,36,0,2,0,0,4,42,0
1,62807,526,28,135,10,21,99,819,1
0,72906,400,32,519,71,75,54,1151,2
2,61467,410,16,114,0,5,49,594,1
2,49618,80,3,26,4,2,14,129,0
1,21888,88,10,46,2,3,64,213,0
1,42429,55,0,6,2,0,4,67,0
3,26150,5,1,13,3,5,1,28,0
1,30801,8,4,5,15,2,11,45,0
0,81168,410,0,592,147,22,22,1193,2
0,26877,101,13,76,20,18,40,268,0
0,45006,162,25,53,16,0,10,266,0
1,18978,2,8,1,4,7,15,37,0
3,22574,25,0,8,2,0,2,37,0
0,48240,389,91,248,64,49,41,882,2
2,45837,215,13,87,17,17,24,373,0
3,35791,27,0,5,0,0,3,35,0
2,54162,5,6,10,6,5,10,42,0
1,30522,179,8,83,19,11,26,326,0
1,54456,352,0,27,10,0,15,404,0
0,31632,17,8,12,11,15,32,95,0
0,72298,625,35,169,58,17,35,939,1
1,36975,10,6,11,0,4,2,33,0
0,72635,390,22,323,104,35,107,981,2
1,13624,10,2,15,2,1,6,36,0
1,84196,215,63,507,231,31,190,1237,2
1,70971,1001,17,572,93,125,17,1825,2
2,34487,19,18,33,24,1,8,103,0
1,28769,41,5,129,10,3,3,191,0
1,69084,1181,107,199,39,30,30,1586,2
0,65488,603,45,207,36,18,54,963,1
1,62466,129,129,259,168,121,83,889,2
0,32218,10,24,15,13,1,30,93,0
0,83917,514,22,732,42,198,79,1587,2
3,46102,14,0,1,0,0,1,16,0
0,84574,387,20,713,38,54,163,1375,2
1,56181,121,103,69,8,44,48,393,1
1,63120,965,69,279,54,41,69,1477,2
1,73691,707,21,250,85,43,73,1179,1
1,63381,571,50,142,33,50,159,1005,1
0,76140,586,66,653,17,0,26,1348,2
1,62859,1063,89,102,16,12,25,1307,1
1,45906,305,3,27,4,3,144,486,1
0,77632,1200,105,758,0,42,147,2252,2
2,46463,163,2,40,8,11,11,235,0
0,105471,1009,181,104,202,21,207,1724,2
1,55282,125,6,73,8,4,19,235,0
1,78710,721,0,152,119,50,50,1092,1
1,66886,315,4,62,41,31,146,599,1
0,98777,1000,19,711,125,115,38,2008,2
1,29103,16,0,17,6,3,6,48,0
1,67445,757,80,217,29,80,11,1174,1
1,50616,30,2,25,0,1,9,67,0
1,49431,219,3,100,26,0,17,365,0
1,61278,111,3,28,2,6,15,165,0
0,26490,45,47,52,21,20,25,210,0
1,73059,410,112,420,0,82,71,1095,1
3,46734,100,1,39,6,1,76,223,0
1,56253,509,0,65,7,11,5,597,1
1,19986,3,6,5,0,2,6,22,0
1,58330,445,53,213,104,98,151,1064,2
0,25965,2,2,11,41,7,11,74,0
0,14661,4,1,11,6,2,2,26,0
0,18690,6,1,7,23,4,19,60,0
1,45068,14,0,3,0,0,3,20,0
1,21063,1,10,11,19,3,15,59,0
1,29187,26,0,6,0,0,2,34,0
2,54690,111,16,37,7,9,18,198,0
1,59304,418,61,428,80,51,10,1048,1
2,59247,327,9,122,19,14,83,574,1
1,66731,371,159,194,58,106,141,1029,2
1,77353,275,59,107,69,101,59,670,1
1,52614,789,0,142,12,9,38,990,1
2,26751,1,1,5,0,3,1,11,0
1,81300,1004,12,145,32,12,36,1241,1
0,70337,187,81,149,25,43,91,576,1
1,36145,56,4,76,17,1,18,172,0
0,65295,365,32,117,34,110,6,664,1
1,68118,595,23,123,10,23,154,928,1
0,68743,1132,134,384,175,134,115,2074,2
0,41039,34,11,137,179,61,45,467,1
1,38946,116,6,82,6,6,41,257,0
0,65777,565,32,435,28,32,54,1146,1
1,66476,372,18,126,47,48,78,689,1
0,86857,899,102,838,133,102,40,2114,2
0,77845,760,40,480,0,40,26,1346,1
0,69476,260,86,559,63,9,67,1044,2
1,50611,459,0,24,6,0,4,493,0
0,61209,466,0,224,119,49,99,957,1
1,42315,67,15,80,17,11,80,270,0
0,13084,2,0,7,3,7,10,29,0
2,47570,67,1,20,0,2,31,121,0
2,61923,92,4,18,3,3,6,126,0
0,34824,4,2,11,2,0,4,23,0
2,26518,20,1,28,3,3,2,57,0
0,45938,273,11,178,62,83,29,636,1
0,78468,434,22,388,104,22,34,1004,2
1,78901,321,11,309,33,26,34,734,1
2,71427,212,123,177,15,64,23,614,1
1,71022,909,12,278,0,12,242,1453,1
0,90247,1184,32,352,21,16,16,1621,2
1,41335,112,19,21,16,14,5,187,0
1,71952,656,80,455,52,107,93,1443,2
1,35682,23,0,8,6,2,18,57,0
1,43185,537,6,42,16,6,30,637,1
1,66375,712,0,45,0,0,191,948,1
1,35178,23,1,13,2,2,18,59,0
1,25252,1,3,4,2,2,6,18,0
1,55250,664,58,83,32,0,66,903,1
1,33249,6,10,21,19,14,42,112,0
0,58398,299,5,201,21,21,49,596,1
1,50272,99,13,66,43,8,4,233,0
0,76618,749,40,294,121,160,147,1511,2
0,87305,345,25,501,63,138,80,1152,2
1,25851,9,4,18,7,5,5,48,0
1,58710,440,81,368,0,122,174,1185,1
2,45160,8,2,5,3,0,3,21,0
1,74806,670,9,249,0,28,9,965,1
0,59111,524,0,134,28,28,155,869,1
1,18988,6,0,6,2,1,1,16,0
0,72190,597,166,597,172,166,249,1947,2
1,7500,7,0,12,13,7,32,71,0
1,44794,54,0,7,0,0,4,65,0
0,80395,445,25,706,80,76,48,1380,2
0,75012,294,142,218,164,58,151,1027,2
3,56962,292,3,77,10,3,26,411,0
0,89891,412,22,132,59,28,183,836,1
2,35946,8,0,3,0,0,0,11,0
2,53593,349,4,78,6,0,43,480,0
2,66373,328,9,124,12,24,109,606,1
3,45072,144,2,99,7,2,30,284,0
2,89694,1126,28,211,37,28,42,1472,1
0,72025,967,0,617,43,50,0,1677,2
1,67432,432,79,341,177,136,170,1335,2
1,70545,138,39,63,55,18,21,334,1
1,17487,0,0,1,7,4,6,18,0
1,62882,509,133,497,78,24,97,1338,2
1,64108,948,10,86,13,21,21,1099,1
2,34941,39,2,25,4,3,24,97,0
3,48767,28,1,21,3,0,10,63,0
1,38702,13,11,24,13,8,40,109,0
0,82224,307,26,360,138,31,40,902,2
0,83844,901,31,345,75,31,191,1574,2
1,17003,2,5,12,4,8,7,38,0
0,71163,283,17,372,138,106,44,960,2
1,33697,4,3,7,0,3,11,28,0
0,63564,769,80,252,15,34,65,1215,2
0,83443,518,42,742,55,56,84,1497,2
1,51518,350,8,66,17,4,4,449,0
1,58330,445,53,213,104,98,151,1064,2
0,80952,778,178,689,41,27,44,1757,2
0,75507,709,93,374,104,80,80,1440,2
0,63855,359,35,314,93,116,89,1006,2
1,62220,799,12,375,16,12,12,1226,1
1,58512,895,10,101,13,0,152,1171,1
1,40662,40,2,23,0,4,23,92,0
1,38829,76,0,7,0,0,16,99,0
1,35523,11,5,22,12,5,11,66,0
2,79146,245,16,223,21,43,16,564,1
0,78285,647,107,391,175,67,40,1427,2
1,31626,39,1,9,2,1,34,86,0
0,75127,203,35,305,46,17,227,833,1
1,48726,138,3,38,4,0,59,242,0
0,74985,587,51,898,247,0,86,1869,2
0,67430,595,97,291,127,133,121,1364,2
1,46891,43,12,23,29,15,61,183,0
1,62058,301,7,74,10,0,58,450,1
1,72063,180,32,348,76,32,90,758,1
0,78939,794,115,243,150,0,205,1507,2
2,42720,392,5,91,28,26,112,654,1
2,33622,39,1,22,3,4,12,81,0
1,6835,107,2,12,2,2,12,137,0
2,41452,13,0,3,0,0,0,16,0
1,40760,70,0,17,0,0,6,93,0
0,74250,680,11,392,75,0,0,1158,1
2,51124,26,1,11,0,1,4,43,0
1,72258,522,0,522,227,120,134,1525,2
0,71466,412,12,546,78,182,0,1230,2
2,36283,6,5,5,8,0,5,29,0
1,20587,2,3,6,4,1,9,25,0
1,30467,1,3,8,2,5,5,24,0
1,31590,6,2,15,6,6,3,38,0
1,20425,4,12,5,3,16,17,57,0
2,17144,18,2,19,0,2,6,47,0
1,42564,324,48,186,39,18,198,813,1
1,43783,327,9,125,25,4,139,629,1
1,40780,229,27,71,13,3,34,377,0
0,62847,521,168,706,80,76,61,1612,2
0,82017,184,23,446,30,23,23,729,1
0,16813,4,8,11,12,2,13,50,0
2,51267,183,2,64,7,2,12,270,0
1,46524,31,19,35,26,14,52,177,0
0,45183,219,3,60,12,9,12,315,0
1,70421,479,28,136,75,14,35,767,1
1,60161,584,44,212,46,8,177,1071,1
0,73926,627,91,597,159,91,15,1580,2
1,19329,24,1,16,12,2,5,60,0
1,61872,330,5,159,36,27,16,573,1
2,46984,19,1,10,2,1,8,41,0
2,34838,28,23,29,29,14,47,170,0
0,82716,606,148,228,15,148,22,1167,2
0,48192,1039,43,204,153,58,29,1526,2
2,49681,411,0,26,0,0,21,458,0
1,56850,34,1,19,2,7,0,63,0
1,55267,161,28,136,32,3,45,405,0
2,59666,623,53,178,23,17,133,1027,1
1,72504,604,26,470,123,161,94,1478,2
0,26872,3,10,8,3,16,32,72,0
1,21359,12,2,17,6,1,10,48,0
0,73170,184,174,256,50,30,32,726,2
1,52750,393,0,239,90,69,69,860,1
0,91820,410,73,747,76,161,30,1497,2
1,65968,376,9,83,19,4,4,495,1
2,30772,7,2,4,2,1,4,20,0
0,22507,68,0,226,51,157,68,570,1
1,65685,642,14,49,0,7,57,769,1
1,25804,8,7,9,13,6,12,55,0
0,76412,840,53,804,23,71,17,1808,2
1,22063,7,10,13,3,11,11,55,0
0,57091,464,5,64,7,0,37,577,1
0,22419,30,3,47,19,21,42,162,0
1,87771,1492,38,287,50,57,33,1957,2
1,78353,752,122,476,39,153,34,1576,2
3,93404,1279,15,287,20,0,15,1616,1
3,37859,22,1,8,2,1,2,36,0
1,80995,860,28,409,73,56,56,1482,2
1,16529,3,0,5,13,0,1,22,0
2,55412,10,5,28,11,1,8,63,0
0,48789,351,16,156,7,5,145,680,1
2,56575,421,5,90,0,16,10,542,0
1,25130,2,5,7,0,18,18,50,0
2,35441,25,1,9,2,1,1,39,0
1,71391,336,123,274,46,123,141,1043,2
1,49494,191,9,97,0,6,82,385,0
0,81702,563,50,774,28,31,187,1633,2
1,45889,31,0,6,0,1,8,46,0
1,56628,479,5,82,7,17,171,761,1
2,34026,18,6,15,12,8,17,76,0
1,40049,91,65,52,10,44,28,290,0
1,34176,5,7,24,19,14,20,89,0
1,19419,2,14,28,16,3,7,70,0
0,82504,362,50,431,134,35,54,1066,2
0,81205,724,74,929,97,55,130,2009,2
0,61618,605,91,399,0,45,205,1345,2
1,55284,547,7,140,0,7,63,764,1
1,49980,104,1,54,13,9,14,195,0
2,15072,8,2,15,0,10,18,53,0
1,49166,224,2,25,7,0,110,368,0
1,65324,384,0,102,21,32,5,544,1
0,82347,556,54,845,202,133,63,1853,2
2,30843,24,0,2,0,0,9,35,0
1,46374,408,0,21,0,0,17,446,0
1,60474,265,199,303,234,9,170,1180,2
1,38576,34,0,7,0,0,0,41,0
2,55357,374,64,116,84,25,64,727,1
2,37758,27,2,10,0,0,1,40,0
0,85710,600,20,350,29,30,33,1062,1
1,23228,13,2,18,6,1,0,40,0
2,44602,167,2,89,0,0,34,292,0
0,7500,0,2,3,4,1,5,15,0
1,38683,46,35,69,84,41,66,341,0
1,49514,88,39,78,58,13,93,369,0
1,57906,243,11,119,10,3,15,401,0
1,43456,275,11,68,25,7,7,393,0
2,19485,6,0,4,0,0,0,10,0
1,53172,121,62,90,68,20,125,486,1
1,30545,4,12,15,19,7,12,69,0
0,70123,1308,0,396,23,0,0,1727,1
1,62450,515,47,267,62,66,38,995,1
1,21675,4,0,16,17,4,4,45,0
2,42395,48,13,57,24,15,25,182,0
1,61346,562,58,168,43,16,142,989,1
0,80812,769,22,500,210,143,33,1677,2
2,42835,379,4,93,12,9,98,595,0
1,39922,29,12,59,19,1,36,156,0
0,86424,387,68,569,89,45,68,1226,2
1,17117,12,23,38,30,18,7,128,0
1,24762,6,10,12,3,15,40,86,0
1,35797,27,1,14,4,1,21,68,0
2,36627,9,1,5,0,0,1,16,0
2,51111,22,0,19,6,5,3,55,0
0,86857,899,102,838,133,102,40,2114,2
0,82072,889,55,685,168,92,129,2018,2
3,46231,189,2,55,0,5,12,263,0
2,42243,48,0,2,0,0,5,55,0
2,51195,230,14,156,82,24,58,564,0
0,68092,852,60,207,78,36,48,1281,2
1,31814,35,3,20,4,1,20,83,0
2,51390,205,20,47,23,2,56,353,0
0,76630,255,31,446,40,56,175,1003,1
1,26868,0,0,1,8,3,2,14,0
0,48948,437,8,206,160,49,42,902,2
1,55260,825,8,53,11,0,242,1139,1
1,64090,316,58,161,76,51,135,797,1
1,78331,756,138,354,160,169,61,1638,2
1,37087,194,55,134,15,0,3,401,0
1,21846,7,17,18,6,10,26,84,0
0,81320,183,33,493,59,103,57,928,2
1,54137,171,0,11,0,1,20,203,0
0,66825,243,101,405,29,40,40,858,1
0,57100,181,21,69,39,3,96,409,1
3,58917,151,7,89,0,7,28,282,0
0,85072,494,92,391,194,11,241,1423,2
0,86429,464,28,873,29,18,37,1449,2
1,45684,5,1,5,10,0,7,28,0
1,47889,29,0,29,0,5,4,67,0
0,45921,102,9,49,24,3,12,199,0
0,78420,604,28,674,91,28,28,1453,2
0,75114,571,12,523,63,60,24,1253,2
1,52278,953,0,71,0,0,174,1198,1
1,35641,63,3,67,8,9,28,178,0
0,95529,770,29,890,250,27,24,1990,2
0,62820,398,61,265,138,61,53,976,2
0,73113,741,19,154,50,9,28,1001,1
0,84169,1478,19,403,0,19,0,1919,2
1,42607,156,29,56,30,32,47,350,0
0,74637,960,64,464,146,0,16,1650,2
2,46015,38,0,2,0,0,6,46,0
0,72354,315,26,473,220,12,182,1228,2
1,39858,15,20,25,2,7,26,95,0
2,34469,19,6,20,0,5,12,62,0
1,83033,812,99,431,237,149,33,1761,2
0,24401,73,28,217,10,24,115,467,0
0,77583,372,23,384,250,12,108,1149,2
0,74116,871,111,704,145,55,166,2052,2
0,74293,375,152,335,93,91,81,1127,2
1,68397,760,80,466,17,13,80,1416,1
0,79632,471,0,510,99,21,12,1113,1
1,46107,31,9,27,16,9,33,125,0
1,64950,819,0,72,12,0,63,966,1
1,25443,1,4,3,8,9,7,32,0
0,75127,203,35,305,46,17,227,833,1
1,32892,26,0,15,2,1,2,46,0
0,71796,354,21,311,167,75,32,960,2
1,67536,1253,0,447,23,71,35,1829,1
1,55239,371,17,238,23,24,106,779,1
1,60554,588,7,76,110,15,15,811,1
2,64831,480,86,249,75,86,144,1120,1
1,56067,517,12,54,16,6,120,725,1
0,82025,267,98,606,48,70,98,1187,2
0,94384,1111,24,790,160,45,172,2302,2
0,14906,7,7,14,7,16,15,66,0
0,51563,1166,0,48,0,0,36,1250,1
1,57937,261,42,144,55,48,133,683,1
2,68274,135,25,51,23,25,46,305,0
1,39771,6,2,18,2,8,14,50,0
1,67893,711,28,142,49,18,47,995,1
1,27922,11,0,13,2,4,11,41,0
2,52190,42,0,17,0,0,18,77,0
2,44051,79,7,58,6,3,18,171,0
2,42767,20,6,43,19,5,38,131,0
2,46106,30,0,8,2,0,14,54,0
2,16927,20,2,23,3,1,4,53,0
1,59754,115,27,44,4,146,139,475,1
1,53700,263,5,233,69,41,83,694,1
2,59041,69,2,15,2,2,6,96,0
1,54237,267,3,30,4,0,57,361,0
1,70647,561,85,171,25,123,114,1079,1
1,52597,492,0,37,7,0,42,578,1
1,41021,14,7,9,6,16,12,64,0
1,40233,80,4,46,0,17,2,149,0
2,50183,97,12,84,13,10,15,231,0
1,54753,197,107,227,7,59,131,728,1
0,92955,693,21,925,31,24,84,1778,2
1,33471,43,2,27,0,9,12,93,0
1,34596,14,0,2,0,0,7,23,0
1,44010,186,36,234,86,72,48,662,1
0,84219,434,137,400,45,137,45,1198,2
3,40706,59,0,11,4,2,5,81,0
1,15716,16,5,30,8,7,26,92,0
1,59052,230,35,75,63,57,31,491,1
0,80573,829,138,430,60,92,15,1564,2
0,83715,318,8,407,150,35,8,926,2
0,82576,1206,55,445,168,18,18,1910,2
3,56962,292,3,77,10,3,26,411,0
2,35704,30,9,12,2,11,30,94,0
1,53103,729,17,133,11,0,195,1085,1
2,46779,12,1,3,0,0,7,23,0
0,4861,2,1,1,1,0,1,6,0
1,33462,22,3,18,0,0,11,54,0
1,63693,587,43,337,42,87,54,1150,1
0,80763,674,168,108,192,42,231,1415,2
1,65352,284,3,84,4,7,23,405,0
0,82170,1023,93,651,49,55,37,1908,2
0,75759,1394,22,708,89,91,182,2486,2
0,79689,311,26,640,180,37,121,1315,2
2,35340,27,0,12,0,1,5,45,0
0,85683,1296,17,311,45,69,51,1789,2
1,24884,3,6,7,0,0,3,19,0
1,42021,393,5,136,7,5,27,573,0
1,64449,218,63,282,137,35,70,805,1
2,64587,66,0,16,0,6,20,108,0
0,34824,4,2,11,2,0,4,23,0
0,75437,795,0,545,95,58,0,1493,2
2,26091,15,10,19,8,17,20,89,0
1,52845,384,25,292,130,41,64,936,1
1,46086,244,8,32,7,2,50,343,0
1,78028,158,19,288,25,0,38,528,1
0,95169,1285,21,449,106,20,20,1901,2
2,56337,349,16,144,28,5,182,724,1
1,22434,4,12,11,3,13,15,58,0
1,36930,223,2,31,0,2,39,297,0
1,36130,157,43,127,68,56,37,488,0
1,65569,397,46,288,20,38,70,859,1
0,83844,901,31,345,75,31,191,1574,2
2,19514,14,3,21,2,1,28,69,0
2,36736,10,0,3,0,0,4,17,0
1,77568,1230,0,396,232,178,158,2194,2
1,49187,81,1,31,2,1,0,116,0
1,30168,154,20,66,0,12,27,279,0
1,34053,63,0,21,7,0,12,103,0
2,38196,30,0,11,0,0,3,44,0
0,59412,90,67,165,30,43,11,406,1
0,70924,635,114,254,132,152,76,1363,2
0,54165,127,4,73,15,6,11,236,0
1,32300,13,3,6,6,5,6,39,0
0,20180,18,42,24,15,20,18,137,0
1,34961,45,2,26,4,1,1,79,0
1,28440,38,1,24,0,0,0,63,0
3,64504,986,36,168,16,0,108,1314,1
1,33564,61,0,3,0,0,7,71,0
1,17345,4,9,16,17,0,12,58,0
1,56320,201,53,172,116,77,83,702,1
1,28647,19,8,29,0,12,26,94,0
1,15038,4,8,11,19,12,26,80,0
1,32173,18,0,2,0,0,2,22,0
1,68316,806,80,161,120,11,33,1211,2
0,74538,380,98,733,110,112,28,1461,2
0,91700,576,172,961,125,115,19,1968,2
0,68695,458,81,356,106,50,40,1091,2
1,31056,5,10,13,3,8,16,55,0
0,79593,350,60,568,110,133,145,1366,2
0,28071,39,33,130,41,26,44,313,0
2,37334,26,1,16,2,2,15,62,0
2,46423,68,0,16,0,0,8,92,0
1,37126,45,3,9,4,4,7,72,0
1,47703,359,0,134,13,26,123,655,1
1,61180,403,24,29,6,24,218,704,1
2,38998,34,1,14,0,0,5,54,0
0,8028,73,18,66,7,12,2,178,0
0,76081,292,30,415,63,33,200,1033,1
1,34728,14,0,16,0,0,6,36,0
1,33168,80,1,37,0,1,3,122,0
1,33585,30,11,33,13,6,29,122,0
1,77037,463,96,333,168,53,10,1123,2
1,35196,75,12,141,43,39,187,497,1
1,44529,538,13,91,17,6,26,691,1
0,70924,635,114,254,132,152,76,1363,2
2,28764,8,0,3,0,0,1,12,0
0,69098,1315,22,780,145,0,178,2440,2
2,25959,4,2,12,7,5,26,56,0
1,27100,12,0,13,2,0,10,37,0
0,70596,347,44,534,17,0,26,968,1
1,42557,192,5,53,0,5,15,270,0
0,53312,241,0,12,0,0,25,278,0
0,72228,631,28,491,30,14,56,1250,1
0,67605,336,28,282,184,54,54,938,2
2,62845,1099,0,45,0,0,34,1178,1
2,65196,743,19,181,12,0,200,1155,1
0,42000,124,83,267,85,59,35,653,1
2,35860,15,0,8,4,2,20,49,0
1,65526,397,19,69,12,0,9,506,1
2,16860,10,4,4,3,3,14,38,0
0,83528,530,117,678,134,44,147,1650,2
1,64176,1215,33,249,64,116,149,1826,2
0,22304,3,2,7,0,4,2,18,0
0,67023,444,44,382,11,8,17,906,1
1,32892,26,0,15,2,1,2,46,0
1,70713,736,114,279,82,76,190,1477,2
1,59925,473,21,176,19,21,56,766,1
1,39722,32,0,5,2,0,8,47,0
0,46610,288,10,30,4,10,125,467,1
0,88347,1050,178,555,77,138,118,2116,2
0,87171,1001,44,107,58,44,44,1298,2
2,26907,9,1,7,0,3,2,22,0
1,50014,234,14,77,19,10,42,396,0
1,41014,7,2,6,2,0,3,20,0
0,66294,251,108,334,65,92,117,967,2
1,36715,172,10,125,21,13,16,357,0
0,79456,565,42,548,64,83,99,1401,2
1,40479,5,0,8,2,0,0,15,0
0,75345,918,57,842,99,38,133,2087,2
1,54233,652,8,158,21,0,142,981,1
2,24163,4,1,7,2,1,2,17,0
0,84460,152,27,103,106,54,81,523,1
1,43776,8,0,9,2,1,3,23,0
0,71691,336,130,411,240,32,43,1192,2
0,85844,938,19,843,25,95,38,1958,2
1,39190,68,8,18,19,8,12,133,0
0,71367,227,23,389,42,21,75,777,1
2,38578,38,4,22,3,3,3,73,0
2,57236,105,0,9,2,1,4,121,0
1,61825,162,50,100,55,30,27,424,1
1,79803,574,8,216,21,16,33,868,1
0,80910,160,80,369,67,39,41,756,2
1,27590,6,0,5,0,0,1,12,0
1,56775,614,35,160,58,35,35,937,1
0,83829,897,161,430,186,161,27,1862,2
1,54210,70,54,109,80,9,45,367,0
1,38508,120,19,206,25,19,54,443,0
1,53187,211,2,30,7,7,10,267,0
1,30023,11,0,16,7,6,21,61,0
0,76045,760,53,400,17,93,0,1323,2
1,50870,53,0,8,0,0,2,63,0
0,15315,7,4,13,15,8,17,64,0
1,65463,391,32,70,21,32,16,562,1
2,66480,199,9,57,20,21,6,312,0
0,76773,516,56,449,86,33,16,1156,2
0,81698,709,45,115,30,160,45,1104,2
2,54466,12,0,4,0,0,0,16,0
0,98777,1000,19,711,125,115,38,2008,2
1,16269,19,3,18,3,1,0,44,0
1,71819,1224,28,140,0,14,168,1574,1
1,33569,16,2,18,3,0,24,63,0
0,36262,88,39,54,64,28,153,426,1
0,22634,2,23,11,8,6,46,96,0
1,47025,508,11,59,23,5,29,635,1
1,70566,381,28,215,84,28,21,757,1
1,31605,74,0,42,2,1,6,125,0
2,52034,146,0,93,7,13,73,332,0
1,48526,23,17,23,43,20,9,135,0
1,46734,110,5,137,26,23,29,330,0
2,39552,165,3,147,4,24,41,384,0
2,86358,957,47,494,82,47,95,1722,2
3,46931,41,0,17,3,1,16,78,0
0,16581,1,3,4,2,3,11,24,0
0,63998,176,29,818,0,33,112,1168,1
1,67381,815,8,53,11,0,70,957,1
2,25930,6,1,2,2,0,4,15,0
1,42693,8,4,20,6,3,16,57,0
1,85606,717,42,864,219,30,84,1956,2
0,72903,1067,138,750,0,19,39,2013,2
1,49669,166,5,107,11,8,29,326,0
2,36778,29,4,34,2,4,4,77,0
0,85696,714,76,395,116,0,12,1313,2
0,10979,8,4,10,2,2,4,30,0
1,49678,229,5,56,3,2,20,315,0
1,56129,320,48,133,39,72,48,660,1
1,37155,23,0,26,7,15,3,74,0
1,21282,1,5,8,4,8,20,46,0
1,33419,56,0,12,0,0,18,86,0
0,63285,508,124,249,50,38,134,1103,2
1,21255,29,0,25,2,2,3,61,0
1,42162,46,7,59,2,4,27,145,0
2,54450,454,0,171,8,19,32,684,1
1,57744,350,3,39,0,0,19,411,0
1,26576,10,0,8,0,0,9,27,0
0,57513,735,40,183,52,20,30,1060,1
1,68142,897,126,196,91,112,37,1459,2
1,7500,5,2,3,3,0,5,18,0
0,83145,777,35,731,39,137,114,1833,2
1,54197,162,6,37,6,13,13,237,0
2,23091,35,0,11,0,0,2,48,0
2,46049,342,9,112,19,14,19,515,0
0,56715,258,105,239,237,172,9,1020,2
0,79410,658,80,483,123,13,13,1370,2
1,57304,356,80,329,138,17,106,1026,2
1,44375,213,5,28,7,7,41,301,0
2,54450,454,0,171,8,19,32,684,1
1,59594,457,4,29,0,0,9,499,1
0,80685,241,45,604,34,26,54,1004,1
1,40344,210,0,6,0,0,2,218,0
1,62710,441,35,83,7,29,11,606,1
1,48985,19,13,18,10,7,8,75,0
3,35322,28,9,37,12,7,13,106,0
0,77142,476,75,162,29,151,97,990,2
0,81657,364,40,425,158,60,50,1097,2
0,14421,0,0,2,3,3,8,16,0
0,20130,0,6,3,7,6,12,34,0
0,74214,863,83,547,86,99,33,1711,2
2,66726,349,7,35,0,0,47,438,0
1,23724,5,23,15,0,18,14,75,0
1,47353,184,2,19,8,8,4,225,0
2,33444,8,0,8,0,0,2,18,0
1,54386,277,21,64,62,21,25,470,1
2,28510,44,5,19,0,4,19,91,0
0,90638,1156,120,915,94,144,96,2525,2
1,48070,373,14,83,6,9,19,504,0
1,43140,134,8,76,6,0,11,235,0
1,54959,1148,0,60,0,0,24,1232,1
2,15056,6,12,3,21,6,40,88,0
1,26954,4,1,11,0,0,1,17,0
1,22327,5,4,8,2,0,5,24,0
2,44393,24,2,20,2,2,10,60,0
1,62000,899,0,101,0,0,20,1020,1
1,31497,108,1,28,13,1,4,155,0
2,45894,27,2,7,0,2,13,51,0
0,78579,816,66,549,216,66,99,1812,2
1,67369,1298,0,70,37,14,42,1461,1
1,58401,10,0,11,17,29,29,96,0
1,62307,87,13,34,10,6,10,160,0
2,43641,57,2,51,4,2,23,139,0
1,63841,635,15,100,20,7,131,908,1
1,46891,43,12,23,29,15,61,183,0
1,70091,964,34,137,15,0,11,1161,1
0,78075,572,8,259,34,35,80,988,1
1,59184,341,142,113,259,151,66,1072,2
2,54809,63,6,57,13,13,22,174,0
1,58113,221,104,169,102,78,84,758,1
1,51412,140,3,29,4,5,14,195,0
1,15287,1,2,8,4,3,13,31,0
0,66636,291,10,689,84,10,0,1084,1
1,50965,544,13,85,8,6,29,685,1
0,84618,684,100,801,21,66,0,1672,2
0,18351,1,12,9,0,14,7,43,0
2,40451,35,0,4,0,0,10,49,0
1,36317,87,3,25,3,2,13,133,0
1,42213,309,3,24,4,3,20,363,0
1,65748,172,73,93,95,78,34,545,1
1,77044,625,38,242,50,34,76,1065,1
0,74918,972,59,913,25,19,59,2047,2
2,56721,157,6,39,6,13,75,296,0
2,42160,48,9,45,3,15,20,140,0
1,61559,279,83,88,32,14,34,530,1
2,33629,132,0,16,0,0,4,152,0
0,68682,919,0,505,99,30,45,1598,2
1,34377,62,0,22,3,1,26,114,0
1,8940,1,45,3,4,6,42,101,0
1,26228,2,6,4,3,1,9,25,0
0,77297,408,61,109,48,122,41,789,2
2,40211,51,1,7,2,1,25,87,0
2,33438,62,1,16,3,2,6,90,0
1,75032,952,12,180,47,12,12,1215,1
0,61284,618,15,106,20,7,45,811,1
1,22518,11,7,12,2,2,27,61,0
1,54730,318,3,17,4,7,56,405,0
2,38452,56,0,14,0,0,2,72,0
2,44421,110,5,59,7,1,7,189,0
1,38197,23,0,11,2,1,3,40,0
1,41986,27,5,8,8,3,12,63,0
1,28427,18,3,19,3,3,6,52,0
1,37395,18,0,9,0,1,11,39,0
1,64722,303,0,280,60,147,15,805,1
1,55249,97,1,19,2,0,11,130,0
0,84906,997,15,414,99,30,76,1631,2
1,28691,5,4,13,8,0,4,34,0
2,44213,95,11,35,0,4,7,152,0
1,25707,1,6,2,3,6,3,21,0
3,59062,46,1,12,3,0,9,71,0
1,76624,411,106,147,54,115,66,899,2
0,66000,244,51,270,101,0,45,711,1
1,27683,152,9,121,12,12,45,351,0
0,1730,1,1,3,1,1,1,8,0
1,7500,10,17,18,8,26,40,119,0
2,40521,12,0,5,0,0,4,21,0
1,20427,5,0,4,0,0,1,10,0
1,65106,790,19,133,12,0,19,973,1
0,69969,882,29,514,38,29,44,1536,2
2,67433,615,28,259,12,48,30,992,1
1,77766,1004,59,265,115,59,27,1529,2
1,74716,133,27,421,13,195,71,860,1
1,68118,595,23,123,10,23,154,928,1
2,55158,293,0,87,4,11,23,418,0
1,62972,313,15,47,20,0,192,587,1
1,74190,151,81,86,168,91,64,641,2
2,39356,15,0,2,0,0,6,23,0
0,76653,736,63,946,219,189,126,2279,2
2,35860,15,0,8,4,2,20,49,0
0,90687,982,17,672,23,34,51,1779,2
0,73450,1142,51,415,90,69,37,1804,2
2,31454,28,0,11,0,0,9,48,0
2,47139,46,0,12,0,2,23,83,0
0,83829,897,161,430,186,161,27,1862,2
2,53378,489,6,152,8,6,132,793,1
1,19656,25,4,9,6,8,32,84,0
1,45579,145,1,33,2,1,1,183,0
0,85485,630,26,611,44,18,54,1383,2
0,55956,760,38,104,50,9,38,999,1
1,64191,420,15,186,151,38,15,825,1
1,38808,125,17,52,3,19,30,246,0
2,57183,464,5,64,7,0,70,610,1
1,23748,6,6,29,12,15,8,76,0
1,66303,1090,12,96,16,12,60,1286,1
1,37368,3,2,11,2,2,10,30,0
3,40800,24,0,27,8,30,10,99,0
0,71847,737,21,106,55,63,210,1192,2
1,46149,254,6,71,4,0,27,362,0
0,78687,817,185,687,145,55,241,2130,2
0,49118,620,54,239,99,98,119,1229,2
2,37633,13,4,20,0,0,1,38,0
0,39767,113,61,204,34,26,47,485,1
0,26997,7,23,78,133,49,144,434,1
1,33986,16,2,18,2,1,5,44,0
1,57091,462,0,24,6,0,4,496,1
2,46831,22,2,10,6,4,34,78,0
0,83151,968,147,842,137,42,210,2346,2
0,52531,283,112,151,51,72,125,794,2
0,15759,1,2,5,6,0,3,17,0
1,22804,14,1,7,2,1,1,26,0
1,43050,30,5,24,6,3,8,76,0
2,42997,4,0,5,0,1,5,15,0
2,48918,52,0,9,0,0,1,62,0
1,60033,62,1,57,19,11,48,198,0
1,34043,20,2,14,3,0,10,49,0
1,57811,545,7,114,37,21,78,802,1
0,78569,558,79,622,207,175,95,1736,2
2,7500,6,5,4,13,4,25,57,0
0,94384,1111,24,790,160,45,172,2302,2
0,23148,4,6,8,6,3,10,37,0
2,44267,183,5,65,3,5,49,310,0
0,71626,546,72,376,94,145,72,1305,2
1,60894,606,7,155,10,0,54,832,1
2,50200,266,6,51,8,6,64,401,0
0,81051,1142,29,249,38,29,14,1501,2
0,65169,1074,0,69,0,0,46,1189,1
1,59868,771,51,154,54,10,154,1194,1
1,65695,371,32,189,0,58,6,656,1
0,64857,556,14,717,210,0,43,1540,2
1,45143,202,5,74,11,5,14,311,0
1,74805,209,162,209,41,162,37,820,2
1,59060,35,40,111,36,40,12,274,0
2,27238,37,0,17,0,0,3,57,0
1,47009,171,45,73,59,10,90,448,1
2,46094,12,2,20,3,2,5,44,0
2,40321,44,4,21,6,0,27,102,0
1,37235,20,2,9,4,6,20,61,0
0,81843,779,86,537,34,69,138,1643,2
1,46692,170,6,97,24,12,88,397,0
1,77382,491,48,231,112,105,134,1121,2
2,37774,173,8,107,7,2,176,473,0
1,18393,7,10,13,16,0,4,50,0
1,72828,1205,0,235,19,14,205,1678,1
0,24711,10,7,25,6,3,7,58,0
1,45503,97,4,44,6,1,18,170,0
0,6560,67,11,26,4,3,262,373,0
0,71604,345,53,528,98,75,97,1196,2
1,27244,6,5,17,3,24,46,101,0
2,48752,73,57,100,71,15,0,316,0
1,71434,711,36,217,172,96,168,1400,2
0,90842,774,70,118,182,187,93,1424,2
1,88097,163,0,480,0,126,75,844,1
1,51948,82,33,54,71,30,41,311,0
0,71853,358,108,413,141,97,32,1149,2
0,35876,66,2,40,4,3,14,129,0
1,40049,13,6,7,0,3,3,32,0
1,39660,139,13,78,20,13,36,299,0
1,50127,274,0,21,4,6,15,320,0
1,43263,262,6,61,0,10,102,441,0
2,62845,1099,0,45,0,0,34,1178,1
0,18929,32,0,8,23,4,18,85,0
1,24367,2,4,2,0,11,5,24,0
1,33249,6,10,21,19,14,42,112,0
1,26887,6,7,4,3,4,6,30,0
0,50150,135,46,92,65,61,11,410,1
1,62061,641,7,84,0,30,38,800,1
0,85696,714,76,395,116,0,12,1313,2
0,76542,794,73,573,0,29,14,1483,2
0,70515,420,0,452,182,64,140,1258,2
1,18227,1,2,7,4,3,11,28,0
1,69139,86,12,75,33,15,6,227,0
0,69109,823,25,459,124,29,95,1555,2
1,69627,231,161,215,171,30,53,861,2
1,38136,8,15,27,0,20,33,103,0
0,62159,182,17,259,77,70,29,634,1
0,80695,557,129,984,193,37,18,1918,2
2,33316,79,1,31,4,4,12,131,0
2,58554,368,24,68,38,0,88,586,1
1,17256,6,4,14,8,8,22,62,0
2,53034,160,15,196,15,11,50,447,0
0,52203,488,21,238,56,108,28,939,1
1,59601,691,7,69,0,7,23,797,1
1,75154,543,10,205,160,143,82,1143,2
1,47025,254,7,108,20,0,26,415,0
1,37971,5,4,10,2,2,7,30,0
1,41335,112,19,21,16,14,5,187,0
1,67267,134,11,59,15,2,30,251,0
1,57338,143,6,52,11,8,17,237,0
2,50523,51,4,24,4,7,1,91,0
3,35791,27,0,5,0,0,3,35,0
1,50611,459,0,24,6,0,4,493,0
1,56242,689,8,167,11,8,88,971,1
1,48904,283,10,38,0,13,27,371,0
3,56243,347,0,35,4,3,7,396,0
1,21355,5,13,14,0,5,31,68,0
1,57420,280,0,18,0,0,24,322,0
1,46390,95,14,64,2,9,38,222,0
2,54342,84,10,34,11,10,28,177,0
1,20895,18,3,17,3,0,4,45,0
0,92344,992,24,694,51,19,119,1899,2
2,26907,9,1,7,0,3,2,22,0
2,44964,19,1,17,2,0,2,41,0
0,75507,709,93,374,104,80,80,1440,2
2,53761,158,0,76,13,7,71,325,0
1,22682,10,14,29,4,2,36,95,0
1,38887,25,1,13,0,0,3,42,0
2,41658,8,4,12,15,4,29,72,0
1,29791,14,0,6,0,0,0,20,0
2,63915,622,7,115,30,0,15,789,1
2,39996,11,0,3,0,0,1,15,0
1,26759,25,3,16,8,5,2,59,0
1,63841,635,15,100,20,7,131,908,1
2,51039,100,64,79,65,0,109,417,0
2,60544,201,2,43,3,5,35,289,0
1,65685,642,14,49,0,7,57,769,1
1,37716,97,1,41,6,2,41,188,0
1,36864,204,5,39,17,0,89,354,0
1,44511,513,7,133,46,14,14,727,1
2,36947,88,3,21,4,1,29,146,0
1,47352,172,12,112,8,0,15,319,0
1,67087,329,35,222,130,35,43,794,1
1,57045,296,13,104,11,13,17,454,0
2,36957,100,2,16,2,1,31,152,0
1,69389,422,7,238,69,46,15,797,1
1,80134,1218,16,272,104,0,80,1690,2
2,43142,5,1,7,2,1,4,20,0
0,80589,507,93,520,242,40,26,1428,2
1,34412,52,12,50,4,36,55,209,0
1,57537,191,56,139,51,8,100,545,1
0,22634,2,23,11,8,6,46,96,0
0,51315,68,28,39,16,30,41,222,0
3,36026,20,4,10,6,4,17,61,0
2,24639,20,3,16,0,4,1,44,0
3,34578,7,0,1,0,0,0,8,0
0,65704,279,172,74,38,8,246,817,2
1,63810,977,12,253,16,12,101,1371,1
1,54132,30,1,8,0,0,3,42,0
0,18690,6,1,7,23,4,19,60,0
1,28164,3,18,26,11,8,12,78,0
1,34596,14,0,2,0,0,7,23,0
1,43269,10,1,7,0,0,1,19,0
2,38741,7,10,17,8,6,13,61,0
0,31907,33,87,64,175,16,74,449,2
1,27100,12,0,13,2,0,10,37,0
1,31163,2,3,10,11,2,10,38,0
0,92533,693,21,118,110,147,42,1131,2
2,34853,9,3,15,2,3,2,34,0
2,70844,129,26,67,3,67,2,294,0
2,31086,16,2,11,3,0,16,48,0
2,60544,201,2,43,3,5,35,289,0
0,20491,5,4,5,4,2,10,30,0
0,42523,14,36,11,3,26,35,125,0
1,39922,29,12,59,19,1,36,156,0
2,33402,26,2,19,10,5,8,70,0
2,36408,9,1,4,3,2,3,22,0
1,21645,14,0,23,4,5,19,65,0
0,78427,972,19,595,180,26,138,1930,2
0,82657,966,168,672,246,105,126,2283,2
0,51876,99,27,102,28,48,6,310,0
0,78041,482,35,553,72,160,17,1319,2
1,52852,714,8,99,11,0,47,879,1
0,70038,587,54,348,71,54,130,1244,2
1,69401,399,27,159,58,8,39,690,1
1,46053,56,10,92,19,7,25,209,0
0,77343,227,151,573,98,54,31,1134,2
0,73892,703,102,601,0,58,43,1507,2
1,40304,37,0,17,0,0,3,57,0
0,32727,167,13,180,86,13,70,529,1
0,68695,458,81,356,106,50,40,1091,2
1,43300,91,3,52,2,1,31,180,0
2,26290,15,8,16,11,5,22,77,0
0,93790,1302,68,731,89,114,45,2349,2
0,38410,153,64,123,116,64,14,534,1
1,64866,508,5,21,7,5,10,556,1
1,57957,290,59,177,77,5,29,637,1
2,46015,38,0,2,0,0,6,46,0
1,16531,2,13,6,7,5,11,44,0
1,28072,30,0,10,2,0,5,47,0
1,49476,386,23,95,54,41,196,795,1
1,50725,443,10,75,0,10,48,586,1
0,83844,901,31,345,75,31,191,1574,2
2,41145,9,0,3,0,0,1,13,0
1,67419,846,84,352,91,56,42,1471,2
2,23162,8,3,9,19,4,22,65,0
1,34380,72,7,58,13,1,24,175,0
1,34704,29,0,5,0,1,5,40,0
2,94871,169,24,553,188,0,144,1078,1
1,65148,460,35,422,33,12,153,1115,1
1,39898,69,8,26,12,7,12,134,0
0,64857,556,14,717,210,0,43,1540,2
1,59892,73,0,13,0,1,0,87,0
0,41020,112,1,54,7,7,36,217,0
1,57072,944,0,60,0,0,30,1034,1
1,60474,265,199,303,234,9,170,1180,2
1,62807,526,28,135,10,21,99,819,1
1,19414,2,3,12,3,5,7,32,0
1,19107,2,4,9,10,5,16,46,0
1,75484,378,97,259,197,194,34,1159,2
1,70379,553,25,142,65,67,8,860,1
0,79419,751,127,687,20,15,31,1631,2
3,64014,406,0,30,0,0,8,444,0
1,76998,1449,89,161,69,35,107,1910,2
1,49854,123,17,171,39,0,30,380,0
2,60585,267,42,309,55,42,21,736,1
2,42873,209,0,40,3,2,15,269,0
0,87679,1259,172,815,97,148,33,2524,2
1,57867,344,35,178,15,23,17,612,1
1,35765,22,3,30,0,5,15,75,0
0,65492,247,161,295,210,85,47,1045,2
1,32952,38,0,12,3,1,1,55,0
1,53374,896,10,101,13,10,34,1064,1
1,71706,931,56,253,91,98,14,1443,2
0,68487,758,12,385,33,89,89,1366,2
2,53253,216,9,57,20,9,125,436,0
1,31163,2,3,10,11,2,10,38,0
1,42014,244,15,108,4,15,50,436,0
2,54108,539,6,91,8,6,97,747,1
0,49667,1181,26,120,17,13,39,1396,1
0,63206,750,8,125,11,8,26,928,1
2,57136,306,5,109,21,109,92,642,1
1,46772,350,104,189,197,151,57,1048,2
0,78931,331,197,170,58,152,35,943,2
1,53977,620,16,165,0,24,82,907,1
0,84219,434,137,400,45,137,45,1198,2
2,46098,57,0,27,0,0,36,120,0
1,73538,811,76,428,99,137,107,1658,2
0,79529,423,42,706,73,197,197,1638,2
0,20981,2,12,10,6,13,30,73,0
1,51766,60,51,87,6,20,51,275,0
1,55759,675,0,85,10,7,77,854,1
1,33039,30,8,12,8,8,12,78,0
1,37787,40,1,40,4,3,18,106,0
1,27242,3,17,26,20,1,39,106,0
0,87188,910,111,724,49,74,55,1923,2
0,69930,252,98,827,219,70,196,1662,2
1,37697,34,6,21,11,4,8,84,0
1,37401,19,3,19,3,1,3,48,0
1,3502,2,1,1,0,0,1,5,0
2,58597,490,0,184,10,28,21,733,1
0,82032,332,194,377,149,125,57,1234,2
2,28087,53,8,17,13,0,21,112,0
0,74004,784,48,560,42,176,48,1658,2
1,19740,7,11,3,10,4,20,55,0
1,57036,1171,43,219,19,14,47,1513,1
2,53083,215,7,33,3,0,13,271,0
1,69283,674,62,134,0,26,8,904,1
2,46098,57,0,27,0,0,36,120,0
1,23331,5,36,7,0,10,45,103,0
1,23331,104,20,101,24,15,5,269,0
1,9255,9,0,7,2,0,4,22,0
0,67786,431,82,441,80,20,102,1156,2
1,71969,1000,0,76,0,0,10,1086,1
1,59235,448,40,469,80,0,91,1128,1
1,31928,33,4,24,4,2,5,72,0
2,74881,505,72,270,36,27,54,964,1
0,65819,267,38,701,149,165,63,1383,2
3,51411,14,0,3,0,0,1,18,0
1,51983,631,0,115,10,7,30,793,1
1,42386,65,4,16,0,4,11,100,0
0,30390,10,12,12,25,1,20,80,0
0,30983,51,4,50,12,1,49,167,0
1,66033,293,35,179,46,59,65,677,1
2,37284,11,1,2,2,1,6,23,0
1,57530,50,1,27,6,7,1,92,0
0,76800,173,26,255,35,71,81,641,1
1,63943,423,184,368,13,97,21,1106,2
0,76081,292,30,415,63,33,200,1033,1
1,67445,757,80,217,29,80,11,1174,1
2,37054,12,1,6,0,1,5,25,0
2,47175,167,2,44,6,2,19,240,0
1,31859,3,1,3,8,0,5,20,0
3,27215,30,5,22,8,9,28,102,0
1,70179,532,88,168,69,44,133,1034,1
1,39922,29,12,59,19,1,36,156,0
2,49681,411,0,26,0,0,21,458,0
1,24645,5,3,4,4,1,0,17,0
1,79865,71,99,278,185,121,38,792,2
1,44322,46,0,40,3,0,3,92,0
1,47958,268,11,88,15,3,22,407,0
1,63972,928,63,254,0,12,12,1269,1
1,75315,459,15,171,142,23,31,841,1
2,55517,483,0,108,0,6,36,633,1
3,75283,733,9,180,12,19,66,1019,1
0,82800,1006,22,115,59,68,45,1315,2
2,38998,34,1,14,0,0,5,54,0
0,90638,1156,120,915,94,144,96,2525,2
1,27161,7,4,23,7,0,11,52,0
1,42014,244,15,108,4,15,50,436,0
1,38201,233,0,23,0,0,12,268,0
2,45203,35,3,67,10,8,24,147,0
0,81574,1252,0,465,46,35,0,1798,2
0,34935,34,4,66,3,10,20,137,0
1,60482,255,43,134,37,14,24,507,1
3,34633,8,1,5,0,0,1,15,0
0,78093,368,32,639,13,43,10,1105,1
0,82460,255,47,573,52,32,15,974,1
1,45903,33,8,10,2,10,3,66,0
0,81361,163,23,424,27,65,76,778,1
2,35860,15,0,8,4,2,20,49,0
2,40442,45,12,52,25,22,13,169,0
0,61482,48,58,68,16,66,43,299,1
1,34968,158,6,45,8,2,2,221,0
0,75794,754,160,625,63,32,48,1682,2
1,31497,108,1,28,13,1,4,155,0
0,74268,199,66,315,97,174,41,892,2
1,13724,2,7,5,2,15,27,58,0
1,45143,202,5,74,11,5,14,311,0
1,52569,85,0,3,0,0,7,95,0
1,48432,322,3,50,4,3,42,424,0
2,17144,18,2,19,0,2,6,47,0
1,36108,141,8,129,3,11,47,339,0
1,76445,739,107,309,140,80,35,1410,2
1,36663,18,0,6,3,3,5,35,0
1,53843,378,0,88,19,4,73,562,1
0,90226,1083,108,649,253,151,108,2352,2
0,70638,1016,12,215,16,12,63,1334,1
2,44512,23,1,6,0,0,2,32,0
2,27116,12,1,21,2,2,3,41,0
2,54072,35,0,4,0,0,0,39,0
1,71855,548,31,422,0,112,28,1141,1
1,51250,342,32,230,34,32,40,710,1
1,60432,365,3,15,4,3,11,401,0
1,65526,397,19,69,12,0,9,506,1
0,68655,456,19,832,75,118,38,1538,2
0,12393,5,6,15,11,7,13,57,0
0,64509,836,185,575,24,25,77,1722,2
1,33955,100,2,128,23,7,10,270,0
2,31353,10,0,10,3,1,7,31,0
1,55434,238,115,215,169,69,76,882,2
1,28359,6,0,5,2,1,2,16,0
1,57100,158,11,99,15,11,17,311,0
1,69139,86,12,75,33,15,6,227,0
1,52973,856,0,76,12,9,199,1152,1
1,51717,98,1,17,0,1,5,122,0
1,18793,4,16,20,0,17,20,77,0
0,66664,398,96,447,220,96,32,1289,2
2,50664,313,8,104,6,4,126,561,1
2,54414,109,18,16,24,26,18,211,0
1,54549,216,2,6,0,0,9,233,0
1,47111,595,71,153,120,112,41,1092,2
0,41003,123,133,142,71,44,88,601,2
1,19444,16,0,23,3,2,10,54,0
1,36301,11,12,35,3,5,12,78,0
1,73059,410,112,420,0,82,71,1095,1
1,42731,159,2,51,6,2,24,244,0
2,52854,105,0,10,0,1,0,116,0
1,22775,5,1,8,0,0,1,15,0
2,46681,269,15,69,15,19,38,425,0
1,59821,629,0,70,0,0,35,734,1
1,50002,443,5,71,21,16,82,638,1
0,69755,217,77,373,111,23,93,894,2
2,44078,24,1,10,2,0,4,41,0
1,30560,9,1,5,4,5,7,31,0
2,35924,8,0,14,2,3,7,34,0
2,64140,1459,0,61,0,15,215,1750,1
2,56386,230,48,214,13,32,75,612,1
1,24594,1,3,6,10,0,9,29,0
1,75774,340,21,134,258,14,56,823,2
0,39228,7,1,6,0,3,3,20,0
1,58494,298,7,68,4,0,19,396,0
0,58684,479,35,179,28,7,85,813,1
0,57136,267,140,599,34,12,127,1179,2
2,56551,67,4,32,17,2,16,138,0
1,22448,3,1,8,23,2,18,55,0
0,82014,980,37,265,35,163,31,1511,2
2,34213,50,4,28,6,3,26,117,0
1,25358,19,0,5,0,0,8,32,0
1,35544,30,5,23,4,1,4,67,0
1,36634,213,9,76,4,3,30,335,0
1,62670,539,30,92,80,46,38,825,1
1,50334,284,16,160,84,16,134,694,1
0,72066,1003,34,536,134,51,34,1792,2
2,50729,239,13,143,45,4,52,496,0
2,34916,51,23,82,33,0,42,231,0
1,64892,527,24,230,32,24,65,902,1
2,43602,19,5,12,10,3,19,68,0
0,33996,40,2,15,8,0,6,71,0
1,41473,21,8,20,15,3,9,76,0
2,63246,593,30,91,29,22,7,772,1
2,36732,21,5,3,10,1,7,47,0
1,69084,1181,107,199,39,30,30,1586,2
1,77766,1004,59,265,115,59,27,1529,2
0,37929,202,2,46,3,2,10,265,0
0,86610,446,107,768,33,196,53,1603,2
0,80141,1184,102,673,52,40,40,2091,2
0,72635,390,22,323,104,35,107,981,2
1,69016,726,53,363,123,107,161,1533,2
0,20193,8,8,22,24,11,9,82,0
1,27573,50,15,110,39,15,15,244,0
1,15862,1,1,4,11,9,10,36,0
1,49544,308,0,73,0,0,23,404,0
1,33228,22,2,31,7,4,5,71,0
0,70440,690,117,499,76,102,88,1572,2
2,38232,43,5,28,7,6,33,122,0
2,22554,27,0,10,0,0,4,41,0
1,23536,6,0,3,0,0,1,10,0
1,49413,205,7,41,3,2,46,304,0
2,42231,24,0,8,0,1,4,37,0
0,78789,667,50,850,21,83,83,1754,2
1,56534,691,7,61,10,0,46,815,1
1,58350,493,26,206,116,80,80,1001,1
0,81217,493,70,324,146,40,84,1157,2
1,49090,494,5,82,7,0,100,688,1
0,61787,621,73,414,78,48,85,1319,2
1,18169,9,0,5,0,0,7,21,0
1,24336,1,6,2,8,2,12,31,0
0,18222,12,4,19,12,6,14,67,0
1,62335,243,131,217,85,6,26,708,1
2,42033,11,1,4,2,0,7,25,0
0,86580,532,21,127,26,20,20,746,1
2,41437,29,0,2,0,0,1,32,0
2,73705,612,91,520,258,107,107,1695,2
1,61064,387,126,342,0,45,180,1080,1
2,38452,56,0,14,0,0,2,72,0
1,18358,6,8,19,16,4,4,57,0
1,55012,582,0,65,0,0,13,660,1
1,9722,6,17,16,6,16,42,103,0
1,38175,70,6,69,2,3,3,153,0
1,58656,962,12,194,16,24,12,1220,1
1,52117,112,10,107,30,0,20,279,0
1,64813,293,0,124,179,97,52,745,1
1,54222,199,12,31,3,12,7,264,0
0,83512,1060,61,835,80,20,101,2157,2
1,77520,940,44,396,0,88,58,1526,1
1,41154,44,2,11,2,3,7,69,0
0,80398,342,51,936,207,35,26,1597,2
1,18746,2,10,11,12,9,20,64,0
1,35196,75,12,141,43,39,187,497,1
1,60230,520,20,367,39,81,40,1067,1
2,22108,5,3,9,6,2,6,31,0
2,44392,87,5,71,7,12,29,211,0
1,55424,462,61,184,10,53,107,877,1
1,17688,2,2,1,3,1,2,11,0
0,92491,979,44,935,29,25,22,2034,2
0,90273,704,129,853,120,74,111,1991,2
0,82571,861,31,558,62,95,79,1686,2
1,38513,172,3,115,16,0,18,324,0
1,16653,5,7,31,15,4,7,69,0
2,42586,194,2,56,0,0,0,252,0
1,23529,9,7,13,3,2,20,54,0
2,74881,505,72,270,36,27,54,964,1
1,71107,533,10,217,198,174,195,1327,2
2,46910,48,0,14,0,0,6,68,0
0,18690,6,1,7,23,4,19,60,0
2,37244,18,2,10,0,0,25,55,0
0,82427,482,147,509,104,107,107,1456,2
1,75342,204,97,97,21,118,26,563,1
1,70044,1073,0,250,153,14,14,1504,2
2,79146,245,16,223,21,43,16,564,1
0,77437,560,21,442,29,44,29,1125,1
1,54984,173,13,131,32,3,6,358,0
1,42403,22,1,11,0,5,3,42,0
1,55761,136,1,12,0,3,32,184,0
1,37292,275,0,86,10,23,66,460,0
0,45576,56,19,29,2,14,25,145,0
0,70321,303,23,751,82,26,191,1376,2
1,58086,708,7,62,0,0,15,792,1
0,81795,324,132,693,27,118,88,1382,2
0,28389,1,5,3,7,4,8,28,0
0,66835,620,26,195,34,17,141,1033,1
1,69901,312,21,206,102,92,149,882,1
0,80360,1493,86,454,112,43,43,2231,2
1,63342,918,21,118,13,10,21,1101,1
1,44989,98,0,106,49,10,106,369,0
1,31859,3,4,7,15,8,11,48,0
1,51569,380,0,47,6,0,34,467,0
2,30372,15,0,12,7,3,7,44,0
2,16014,3,9,4,7,8,7,38,0
2,41120,24,2,23,0,8,24,81,0
1,39763,80,1,60,4,6,16,167,0
2,38725,31,0,6,2,1,5,45,0
1,77981,138,120,204,16,126,60,664,1
1,62905,166,75,96,119,107,59,622,1
1,13533,12,3,8,8,0,17,48,0
1,59481,178,3,85,71,66,58,461,1
1,72117,707,20,171,65,60,50,1073,1
1,21955,5,1,7,17,14,11,55,0
1,67131,465,71,250,93,35,62,976,1
1,36802,16,1,2,0,0,1,20,0
0,71853,358,108,413,141,97,32,1149,2
0,28249,1,9,7,2,14,10,43,0
1,47808,123,1,26,2,0,72,224,0
1,25509,40,3,30,10,7,11,101,0
0,51012,102,9,63,2,9,24,209,0
0,70596,347,44,534,17,0,26,968,1
0,85431,376,53,462,168,53,53,1165,2
1,42664,21,0,3,0,0,0,24,0
2,42586,194,2,56,0,0,0,252,0
1,29760,64,4,68,7,5,17,165,0
0,28973,206,0,46,3,2,12,269,0
1,39435,71,0,18,0,0,13,102,0
0,65370,71,22,112,138,89,29,461,1
1,20194,0,4,7,11,10,15,47,0
2,42473,93,1,21,0,4,25,144,0
0,64590,920,138,168,36,46,30,1338,2
1,71232,653,17,170,34,26,17,917,1
2,34600,199,33,60,8,3,15,318,0
2,46904,153,4,56,0,9,31,253,0
1,49094,376,0,38,11,8,69,502,1
1,36075,46,0,30,12,1,30,119,0
2,60839,600,21,128,223,150,128,1250,2
1,77298,425,115,292,23,35,79,969,1
2,34026,18,6,15,12,8,17,76,0
2,48918,52,0,9,0,0,1,62,0
0,82122,734,22,350,151,25,100,1382,2
1,37697,34,6,21,11,4,8,84,0
2,34074,135,1,41,10,1,67,255,0
2,28520,11,0,10,0,2,20,43,0
1,62535,163,48,90,0,45,52,398,1
1,36273,29,3,30,3,2,9,76,0
2,63404,734,26,70,11,44,17,902,1
1,75774,340,21,134,258,14,56,823,2
1,78416,453,38,279,188,38,183,1179,2
1,75702,1073,0,629,145,37,37,1921,2
2,59385,135,0,10,0,4,36,185,0
2,37070,231,7,137,4,15,39,433,0
2,44689,18,0,5,0,0,11,34,0
1,53977,620,16,165,0,24,82,907,1
2,7144,81,4,33,5,2,291,416,0
2,18701,12,4,2,10,6,10,44,0
0,90369,292,51,981,224,23,17,1588,2
0,63159,965,34,586,89,86,37,1797,2
2,37758,27,2,10,0,0,1,40,0
1,46757,777,30,163,0,51,122,1143,1
0,79734,572,8,232,23,62,17,914,1
0,63207,438,169,565,91,169,70,1502,2
1,72071,531,69,300,150,138,150,1338,2
1,21840,17,0,9,0,0,1,27,0
1,58582,402,35,106,101,77,42,763,1
0,72282,503,27,419,90,139,153,1331,2
2,50387,369,9,87,12,14,34,525,0
2,32583,5,0,3,0,0,1,9,0
1,62568,362,17,398,80,35,61,953,1
2,44635,56,0,9,0,0,3,68,0
2,33316,79,1,31,4,4,12,131,0
1,63967,387,84,141,73,35,162,882,1
0,52513,367,17,241,104,188,232,1149,2
1,25293,15,0,11,0,2,9,37,0
1,54111,267,6,54,8,3,50,388,0
0,78394,298,27,697,216,24,166,1428,2
0,80739,674,92,736,39,0,92,1633,2
1,22669,16,14,36,37,22,48,173,0
1,29236,37,4,24,16,9,9,99,0
1,44911,159,0,22,2,1,31,215,0
1,54693,686,17,142,23,26,35,929,1
1,48186,97,3,66,12,7,34,219,0
2,54809,63,6,57,13,13,22,174,0
2,41580,56,5,24,4,0,3,92,0
0,80336,209,19,456,160,142,66,1052,2
1,47743,198,2,43,0,12,20,275,0
1,62972,313,15,47,20,0,192,587,1
1,57333,941,14,397,76,58,176,1662,2
1,32313,86,4,56,2,4,7,159,0
0,84953,167,48,602,63,72,72,1024,2
1,27071,8,3,19,0,2,3,35,0
0,68148,389,66,408,37,57,85,1042,2
2,65735,239,7,119,4,15,11,395,0
0,86836,179,21,273,0,21,63,557,1
2,4023,5,0,1,1,1,1,9,0
0,30093,2,6,28,13,4,16,69,0
1,57705,383,0,53,6,4,40,486,1
1,25008,2,8,8,6,1,9,34,0
0,83257,536,27,590,38,107,67,1365,2
1,22280,2,1,4,3,1,2,13,0
0,72159,322,53,899,34,40,53,1401,2
0,64260,539,169,816,20,0,30,1574,2
0,82733,712,50,420,65,38,38,1323,2
1,74290,1121,0,72,0,12,12,1217,1
3,58217,68,1,13,3,5,13,103,0
0,21024,36,4,18,6,2,18,84,0
0,70116,707,44,603,95,58,29,1536,2
1,54006,174,77,203,6,24,97,581,1
1,69063,666,35,124,69,8,26,928,1
0,11448,0,0,0,6,2,6,14,0
1,61825,162,50,100,55,30,27,424,1
1,70886,407,70,239,103,88,53,960,2
0,69109,823,25,459,124,29,95,1555,2
2,60208,488,23,71,15,0,59,656,1
2,32889,28,0,13,4,2,8,55,0
1,34738,3,2,10,3,0,2,20,0
1,30538,284,0,52,8,3,20,367,0
0,82326,938,142,754,159,81,183,2257,2
1,26642,13,2,15,2,2,8,42,0
1,69932,412,172,153,150,105,57,1049,2
2,44503,31,1,8,0,0,8,48,0
1,60200,502,19,132,0,6,26,685,1
1,49638,18,10,3,3,5,0,39,0
0,23830,1,8,6,4,8,16,43,0
0,33051,100,71,243,108,94,219,835,2
0,72905,407,114,445,181,165,203,1515,2
1,69702,664,9,240,50,19,57,1039,1
1,70300,1045,61,338,60,46,46,1596,2
0,70643,1218,107,304,23,143,33,1828,2
1,30396,15,0,6,0,1,12,34,0
1,50616,128,0,16,0,1,4,149,0
1,62772,581,49,157,43,8,108,946,1
0,30298,6,3,12,6,1,0,28,0
1,52413,185,8,133,56,56,12,450,0
2,44155,22,1,9,0,0,14,46,0
0,86979,584,100,835,65,83,35,1702,2
2,76532,355,30,177,90,138,30,820,1
1,42081,175,10,110,54,6,27,382,0
0,67546,864,134,768,150,38,172,2126,2
0,88420,957,153,612,99,95,153,2069,2
1,31158,25,6,16,20,0,5,72,0
1,61671,641,7,56,0,0,28,732,1
0,69719,273,86,208,177,14,43,801,2
1,49160,122,21,43,25,10,15,236,0
1,24882,1,4,10,29,0,36,80,0
0,90933,1020,31,430,62,63,79,1685,2
0,113734,6,2,3,1,262,3,277,1
1,59292,378,14,68,19,14,14,507,1
2,45759,42,1,18,3,0,4,68,0
0,22148,15,5,14,0,4,11,49,0
0,73395,272,7,80,20,7,11,397,1
1,29819,9,1,24,2,1,2,39,0
1,45688,279,0,18,0,0,9,306,0
0,62820,398,61,265,138,61,53,976,2
1,60491,637,47,237,12,19,76,1028,1
1,33235,45,0,16,2,1,6,70,0
0,35701,21,1,9,7,3,5,46,0
1,31535,15,4,13,0,0,19,51,0
0,92556,493,183,352,184,23,28,1263,2
1,67384,957,40,175,158,53,107,1490,2
0,80573,829,138,430,60,92,15,1564,2
1,77870,1017,50,500,65,50,133,1815,2
1,52278,953,0,71,0,0,174,1198,1
1,57107,159,0,120,0,0,137,416,1
0,18929,32,0,8,23,4,18,85,0
1,36038,23,0,15,0,2,7,47,0
0,20180,18,42,24,15,20,18,137,0
2,34230,15,0,4,0,0,2,21,0
1,31878,23,4,5,10,5,23,70,0
1,70932,200,193,100,46,185,185,909,2
0,91249,1324,27,119,71,108,27,1676,2
0,77598,1193,33,281,129,66,33,1735,2
2,80982,505,137,401,104,22,22,1191,2
1,22701,2,4,9,0,4,5,24,0
1,55212,1103,0,45,0,0,34,1182,1
0,70617,353,61,753,40,46,27,1280,2
0,64849,652,48,350,94,84,108,1336,2
2,62694,379,6,157,25,91,91,749,1
2,61917,46,4,36,2,2,1,91,0
1,67472,162,31,127,8,17,69,414,1
1,21059,8,3,19,3,3,8,44,0
2,29543,17,3,18,3,4,18,63,0
1,75903,340,108,185,130,38,100,901,2
2,34984,8,4,15,3,5,3,38,0
1,54998,154,22,202,39,30,8,455,0
1,54356,710,15,30,20,0,0,775,1
1,34242,8,2,4,0,0,1,15,0
1,25410,2,2,4,13,13,4,38,0
0,73356,1050,14,322,0,14,112,1512,1
1,28320,19,1,14,3,2,4,43,0
1,23763,22,0,6,6,2,6,42,0
0,72570,274,83,216,151,141,224,1089,2
1,34529,68,6,38,3,6,41,162,0
0,70792,344,45,654,104,11,114,1272,2
0,63211,145,193,459,205,26,145,1173,2
1,83891,217,38,350,111,85,15,816,1
2,36065,18,7,34,10,2,3,74,0
1,39898,69,8,26,12,7,12,134,0
0,51141,144,0,7,0,0,6,157,0
1,56939,256,34,103,90,29,49,561,1
0,80872,483,72,567,94,12,108,1336,2
0,72335,1285,105,653,28,21,0,2092,2
0,61798,338,4,89,11,8,13,463,1
0,76842,605,10,345,84,54,32,1130,2
1,29478,8,0,7,3,1,1,20,0
1,46998,172,41,86,45,6,27,377,0
0,96843,448,71,951,40,17,17,1544,2
2,56551,67,4,32,17,2,16,138,0
1,70053,512,53,98,81,179,89,1012,2
0,71670,1462,16,128,0,0,160,1766,1
2,44359,20,0,14,7,3,1,45,0
2,40887,50,4,44,10,10,43,161,0
1,48877,102,1,15,2,0,24,144,0
0,74485,499,149,815,173,49,49,1734,2
1,64474,381,35,172,56,86,93,823,1
1,77226,631,43,239,128,76,21,1138,2
0,72643,526,80,553,123,94,53,1429,2
0,85738,913,26,376,17,26,13,1371,1
1,55686,673,0,199,37,47,26,982,1
1,39062,23,0,9,0,0,12,44,0
2,34600,199,33,60,8,3,15,318,0
1,40794,261,23,73,4,23,50,434,0
2,54690,111,16,37,7,9,18,198,0
1,4428,16,4,12,2,4,321,359,0
0,32632,63,151,137,153,19,53,576,2
2,38236,58,0,18,2,0,10,88,0
1,36781,29,1,17,0,3,13,63,0
1,31385,3,2,12,0,1,9,27,0
1,24570,28,34,62,11,14,44,193,0
1,25509,40,3,30,10,7,11,101,0
0,94642,879,143,797,106,143,143,2211,2
1,58646,62,1,44,6,5,22,140,0
2,53201,280,7,81,20,0,27,415,0
1,21994,9,0,6,3,1,3,22,0
2,57113,182,4,33,0,2,42,263,0
0,51373,83,2,101,64,26,117,393,1
1,23477,38,15,54,3,8,29,147,0
1,58116,228,19,130,4,11,51,443,1
0,72968,1092,37,592,145,37,55,1958,2
1,39791,85,15,27,13,13,21,174,0
0,91712,1276,24,746,94,29,48,2217,2
1,94472,1017,33,417,108,100,16,1691,2
2,13672,6,2,9,2,1,5,25,0
0,96547,448,21,125,52,101,62,809,1
0,79205,504,23,117,179,28,44,895,2
1,56559,226,22,133,41,31,31,484,1
1,32644,239,3,141,0,7,23,413,0
1,67506,90,38,67,33,36,67,331,1
1,24206,7,2,8,3,2,3,25,0
1,28420,4,2,5,2,0,0,13,0
1,22979,16,17,19,20,21,22,115,0
0,33279,10,3,3,0,0,0,16,0
2,46423,68,0,16,0,0,8,92,0
1,30368,35,0,13,2,0,2,52,0
1,63684,575,80,428,208,93,80,1464,2
1,41638,315,0,31,4,0,91,441,0
1,68805,182,2,49,17,13,20,283,0
1,65814,561,14,113,10,14,35,747,1
0,71964,587,51,932,180,34,86,1870,2
1,39146,94,1,33,13,12,12,165,0
0,96876,908,43,735,40,194,21,1941,2
0,34445,228,122,122,208,129,30,839,2
0,68281,995,112,417,42,48,41,1655,2
2,37284,11,1,2,2,1,6,23,0
0,36790,3,3,14,15,21,10,66,0
2,27943,12,1,16,4,1,3,37,0
2,22263,17,0,2,0,0,2,21,0
3,30261,8,0,5,0,3,6,22,0
1,28587,22,4,17,12,10,13,78,0
1,43815,14,10,29,4,7,15,79,0
2,48195,106,27,68,52,7,5,265,0
1,77027,820,57,242,45,0,11,1175,1
1,71322,753,43,226,69,10,204,1305,1
1,32765,13,3,17,7,3,3,46,0
2,29672,9,1,3,0,4,8,25,0
0,23272,19,3,6,4,2,12,46,0
1,49912,520,8,223,32,49,42,874,1
1,7500,5,17,17,13,14,34,100,0
1,68117,618,44,215,0,17,36,930,1
1,67225,315,35,322,46,7,143,868,1
1,17649,15,1,23,0,5,1,45,0
1,55914,384,60,364,119,101,232,1260,2
1,40059,110,29,92,28,10,145,414,0
1,60905,208,17,76,36,17,38,392,1
2,75330,555,82,257,93,61,61,1109,1
1,60689,240,90,216,63,6,24,639,1
1,38680,11,0,36,15,5,12,79,0
0,61416,848,154,323,201,61,78,1665,2
0,49767,202,47,197,55,42,149,692,1
3,83273,433,89,650,16,102,102,1392,1
1,29009,6,6,15,10,5,2,44,0
1,45057,37,0,7,3,0,3,50,0
1,37150,167,37,64,49,34,116,467,1
1,43020,45,7,99,4,25,43,223,0
1,53154,129,0,21,0,1,7,158,0
0,65308,713,0,264,120,80,34,1211,2
1,76467,676,161,426,210,44,58,1575,2
0,81044,450,26,535,73,98,26,1208,2
2,32871,22,2,12,0,2,5,43,0
2,55801,367,4,51,6,4,95,527,1
1,76320,526,35,214,69,53,35,932,1
2,36927,51,0,16,0,0,4,71,0
2,48794,25,0,11,3,0,15,54,0
0,23478,28,6,27,12,17,39,129,0
1,71128,958,159,447,20,0,31,1615,2
1,70179,532,88,168,69,44,133,1034,1
1,59462,724,17,143,0,8,196,1088,1
1,38361,39,0,56,20,8,14,137,0
0,70038,587,54,348,71,54,130,1244,2
2,42554,29,1,11,0,0,0,41,0
1,67445,757,80,217,29,80,11,1174,1
1,67046,544,35,133,23,151,107,993,1
0,42192,40,15,15,17,6,7,100,0
1,77610,1245,33,332,21,33,16,1680,1
1,31761,19,1,20,16,14,28,98,0
1,34350,16,3,15,2,1,11,48,0
1,54591,376,4,94,12,9,24,519,1
1,71866,184,178,178,103,39,33,715,2
1,25293,15,0,11,0,2,9,37,0
0,42000,124,83,267,85,59,35,653,1
0,69520,627,120,414,121,80,93,1455,2
1,64713,180,60,241,13,54,54,602,1
1,27889,14,0,4,0,0,8,26,0
0,22123,3,3,24,34,7,31,102,0
1,27803,8,26,46,38,9,49,176,0
1,51651,293,6,23,13,6,92,433,1
0,68487,758,12,385,33,89,89,1366,2
1,56796,656,38,161,62,47,37,1001,1
0,87000,196,25,607,67,17,49,961,1
1,79823,835,73,380,114,73,43,1518,2
1,30828,16,11,15,2,0,12,56,0
1,34109,9,1,5,2,1,4,22,0
2,53367,229,7,140,10,3,11,400,0
0,22390,0,1,4,15,1,5,26,0
1,71322,121,24,124,24,15,42,350,1
1,49912,520,8,223,32,49,42,874,1
2,48699,26,1,10,2,0,1,40,0
0,80144,240,132,445,250,192,108,1367,2
2,54252,178,4,26,8,4,44,264,0
1,81929,1486,55,278,49,0,185,2053,2
1,76068,1115,12,128,33,12,76,1376,1
2,53204,29,0,8,2,0,6,45,0
1,67911,529,0,356,63,28,0,976,1
1,14796,13,3,8,7,4,16,51,0
1,78128,934,24,230,16,24,36,1264,1
0,14188,2,7,11,16,12,27,75,0
1,20425,4,12,5,3,16,17,57,0
1,58646,62,1,44,6,5,22,140,0
1,72967,158,35,179,0,0,125,497,1
1,48150,173,2,39,3,2,47,266,0
0,82332,830,59,968,51,79,19,2006,2
2,58275,189,10,253,56,43,64,615,1
0,44953,728,17,133,11,8,124,1021,1
2,34587,7,2,9,2,0,2,22,0
1,43018,35,4,17,7,6,64,133,0
1,45736,188,3,180,20,3,43,437,0
1,66476,742,28,152,25,9,57,1013,1
1,27733,0,7,5,26,2,17,57,0
1,69805,750,71,174,13,10,20,1038,1
0,72217,816,42,450,55,56,154,1573,2
1,25818,5,2,8,2,2,9,28,0
1,37509,37,5,56,12,8,5,123,0
2,25176,4,0,4,0,0,5,13,0
1,43586,99,2,11,4,0,16,132,0
1,53230,176,72,98,136,21,229,732,1
2,50116,54,0,10,0,0,2,66,0
0,84906,997,15,414,99,30,76,1631,2
1,61286,356,0,107,19,9,117,608,1
0,82333,1311,0,359,46,89,17,1822,2
0,65220,890,63,292,0,25,12,1282,1
3,33590,4,0,2,0,0,2,8,0
1,30992,17,0,14,7,3,2,43,0
0,72309,960,0,883,50,38,0,1931,2
1,16005,1,3,2,20,30,47,103,0
1,58692,301,11,61,4,7,11,395,0
2,40590,154,0,50,6,11,37,258,0
1,20587,2,3,6,4,1,9,25,0
1,62637,104,12,48,4,12,5,185,0
2,29435,70,3,37,4,2,64,180,0
1,19346,2,0,9,3,6,2,22,0
2,35788,23,2,11,3,1,4,44,0
2,36997,43,4,12,8,0,27,94,0
0,23539,4,24,11,16,1,25,81,0
1,65333,654,7,92,0,15,30,798,1
0,78499,912,72,170,47,36,97,1334,2
1,29732,25,0,8,0,1,4,38,0
3,41275,24,4,22,0,2,9,61,0
2,63516,141,11,114,15,14,5,300,0
1,42769,71,0,13,3,1,0,88,0
2,49572,35,1,16,0,1,1,54,0
0,69209,496,32,849,229,48,128,1782,2
1,17148,9,9,11,13,10,16,68,0
2,40590,154,0,50,6,11,37,258,0
1,30560,9,1,5,4,5,7,31,0
1,32146,26,3,23,4,7,3,66,0
2,41713,77,8,44,10,10,25,174,0
1,34176,11,2,7,4,2,2,28,0
1,58482,576,7,115,19,7,7,731,1
1,59686,89,15,89,34,42,5,274,0
1,60896,1013,30,399,60,46,153,1701,2
1,62994,224,12,48,4,12,12,312,0
1,47320,200,19,111,50,15,19,414,0
0,74859,570,73,614,133,102,73,1565,2
1,15253,1,3,3,8,1,13,29,0
1,31560,62,1,20,4,0,7,94,0
1,72071,531,69,300,150,138,150,1338,2
0,91172,162,28,818,0,28,56,1092,1
0,90000,675,144,133,94,192,241,1479,2
2,41967,23,4,10,0,2,15,54,0
1,69263,492,5,32,13,5,21,568,1
0,65706,918,10,129,13,0,129,1199,1
1,60934,224,155,155,192,93,54,873,2
1,71965,572,19,286,50,38,248,1213,1
1,65210,626,0,70,0,7,28,731,1
0,79174,1074,37,518,193,92,129,2043,2
0,81380,741,68,689,224,68,103,1893,2
1,52914,254,10,44,30,10,227,575,1
1,38946,116,6,82,6,6,41,257,0
1,26067,22,2,18,0,2,12,56,0
1,44325,516,0,21,0,0,5,542,0
0,42523,14,36,11,3,26,35,125,0
1,26487,2,8,10,12,14,23,69,0
1,53233,28,0,9,3,0,0,40,0
1,67716,530,142,217,62,9,56,1016,2
1,76234,519,50,167,130,0,41,907,1
0,84117,611,76,749,59,45,26,1566,2
0,65487,240,67,500,199,0,163,1169,2
1,25224,4,9,12,11,2,8,46,0
0,89616,671,47,655,145,111,15,1644,2
2,40851,23,1,7,0,4,24,59,0
0,27469,9,1,2,3,2,0,17,0
0,82347,556,54,845,202,133,63,1853,2
1,73803,833,80,363,52,26,174,1528,2
2,8820,12,0,13,4,2,4,35,0
0,43322,56,7,48,10,2,18,141,0
1,55593,293,8,124,11,4,106,546,1
2,50501,297,0,38,13,0,152,500,0
2,37085,39,1,16,2,0,3,61,0
1,16185,5,11,16,21,8,45,106,0
1,57731,266,21,300,65,8,44,704,1
1,73807,366,124,156,71,78,54,849,2
0,18929,32,0,8,23,4,18,85,0
2,35893,158,0,23,0,0,18,199,0
1,61014,269,129,495,182,43,29,1147,2
2,32144,41,0,10,0,0,3,54,0
1,14918,3,3,3,15,4,15,43,0
2,45146,33,0,5,0,0,15,53,0
1,41769,302,29,131,32,0,27,521,0
0,88325,519,71,860,93,27,53,1623,2
2,38054,23,2,17,2,1,0,45,0
0,80617,594,51,631,72,55,32,1435,2
1,5305,12,4,7,1,3,5,32,0
2,36807,4,2,5,0,0,5,16,0
1,28427,18,3,19,3,3,6,52,0
0,82032,332,194,377,149,125,57,1234,2
1,22775,5,1,8,0,0,1,15,0
1,40101,171,3,129,26,24,62,415,0
1,58025,270,31,88,11,48,22,470,1
0,75777,712,26,538,69,13,80,1438,2
1,7500,2,8,11,3,8,21,53,0
3,33562,21,12,12,0,3,3,51,0
1,57642,580,6,58,8,0,27,679,1
2,58554,368,24,68,38,0,88,586,1
2,63777,457,5,106,15,17,53,653,1
1,57967,229,7,137,4,0,91,468,1
2,24434,3,2,8,20,0,17,50,0
1,11012,24,3,26,7,1,23,84,0
0,44802,853,10,143,13,10,20,1049,1
0,26816,5,1,6,3,4,3,22,0
1,34421,3,3,7,6,2,9,30,0
1,61223,709,43,182,42,118,247,1341,1
3,64014,406,0,30,0,0,8,444,0
0,56981,908,48,217,32,12,24,1241,1
1,69245,428,30,214,80,30,61,843,1
2,52869,84,3,61,2,1,21,172,0
